# 「基本辞書データ（カナ、謹慎）.dic」片山博文MZ
# This file is public domain software.
アイ	いとしく思う心。好きだなと思う気持ち。
アイカギ	同じ形のキー。
アイケン	犬をかわいがること。かわいがっている犬。
アイコク	自分の国をいとしく思うこと。
アイコトバ	前もって決めた合図の言葉。
アイサツ	人と会ったり別れたりするときの言葉。
アイシヤ	愛用している自分の自動車や自転車のこと。
アイシヨウ	親しみの気持ちをこめて呼ぶ呼び名。
アイス	英語で氷のこと。
アイズ	前もって決めていた方法や印で物事を知らせること。
アイダ	２つのものにはさまれた部分。
アイダガラ	人と人の関係。
アイテ	もう一方の人。
アイデア	気のきいた考え。思いつき。
アイデイア	気のきいた考え。思いつき。
アイドク	このんで読むこと。
アイドル	みんながあこがれ、尊敬する人。
アイボウ	いっしょに仕事をする人。パートナー。
アイマ	物事と物事の間の時間。
アイヨウ	いつもこのんで使うこと。
アイロン	着る物や布などのしわを熱でのばす道具。
アウト	野球で打者や走者がだめになること。
アオ	よく晴れた空のような色。
アオゾラ	青い空。
アカ	血のような色。
アカギレ	寒さのためにできる手足の皮のひび割れ。
アカゴ	生まれたばかりの子ども。ベビー。
アカサビ	鉄などにできる酸化鉄。黒ではない。
アカシオ	プランクトンのせいで海水の色が変化する現象。
アカジ	収入よりも支出が多くなってお金が不足すること。
アカツキ	明け方。あることが実現したとき。
アカツチ	鉄分を含む粘土質の土。
アカラサマ	かくさずはっきりとしているさま。
アカリ	ひかり。光を出すもの。
アカンボウ	生まれたばかりの子ども。ベビー。
アガリ	すごろくなどの終わり。おしまい。
アキ	夏の次のすずしい季節。
アキチ	何の目的にも使われていない土地。
アキナイ	品物を売り買いすること。売り上げ。商売。
アキヤ	人が住んでいない家。
アクシユ	親しみや喜びの気持ちをこめてお互いの手を握り合うこと。
アクシヨン	行動。活動。演技。
アクセル	ペダルを踏むと速度が増す加速装置。
アクセント	一つの言葉の中で高く言ったり、強く発音したりするところ。
アクビ	眠いときやたいくつなときなどに自然に起こる深呼吸。
アクリヨク	物をにぎりしめる力。
アゲモノ	熱した油で調理した食べ物。てんぷら、からあげなど。
アコガレ	強く心がひかれること。
アゴ	人や動物が物をかんだりするときに動かす口の周りの部分。
アサ	夜が明けてしばらくの間。
アサツテ	明日の次の日。
アサツユ	一日の始まりに降りた水のしずく。
アサネ	一日の始まりにおそくまでねぼうすること。
アサネボウ	一日の始まりに決まった時間より寝過ごしてしまうこと。
アサバン	一日の始まりと終わり。
アサヒ	一日の始まりに昇る太陽。
アザ	ひふの色が部分的にむらさきや黒に変わっているところ。
アシ	人の胴の下にあり、歩いたり走ったりときに使う体の部分。
アシアト	地面に残る靴やはだしの形。
アシオト	歩いたり、走るときに聞こえる。
アシクビ	くるぶしの上の少し細くなったところ。
アシタ	今日の次の日。
アシドメ	自由に出歩けないこと。
アシドリ	歩き回った道筋。「犯人の○○○○を追う」
アシバ	靴で踏む土台。
アシブミ	同じ場所で両足を交互に踏み下ろすこと。
アシヘン	漢字の「跡」「路」などの左側の部首。
アシモト	地に付いている場所の付近。
アジ	飲み物・食べ物が舌にあたえる感じ。
アジツケ	調味すること。
アジミ	少し食べたり、なめたりして、食べ物の風味を調べること。
アジワイ	食べ物の風味の深さ。
アス	今日の次の日。
アズキ	赤黒く小さな豆。赤飯やあんを作るのに使う。
アセ	暑いときや運動したときにひふから出る水分。
アセモ	汗をかいたあと、ひふにできるふきでもの。
アソビ	楽しむために遊ぶこと。
アタイ	数学で文字や式が表す数量。
アタシ	女の人が自分を指す言葉。
アタツク	英語で攻撃や挑戦のこと。
アタフタ	あわてる様子。あわてて急ぐ様子。
アタマ	首から上のところ。
アタリ	ねらったとおり、的に当たること。
アタリマエ	決まりきったこと。
アダナ	ニックネーム。
アツカイ	物を使ったり運んだりすること。もてなし。
アツギ	衣服をたくさん重ねて着ること。
アツサ	気温や温度が高いこと。
アツシユク	気体や物体に力を加えて、その体積を小さくすること。
アツシヨウ	段ちがいの強さで勝つこと。
アツデ	布・紙・陶器などの生地が分厚いこと。
アツトウ	くらべものにならないほどまさっていること。
アツパレ	人の行いを感心してほめる言葉。
アツプ	英語で上へ上げること。「成績○○○」
アツマリ	同じ場所に集中すること。集中したもの。
アツミ	物の両方の面の隔たりが大きいこと。
アツリヨク	物をおしつける力。または、その強さ。
アテ	前もって頼りにすること。
アテサキ	手紙や品物を送る相手の名前や住所。
アテナ	手紙や書類などを送る相手の名前。
アテハズレ	期待や見込みがはずれること。
アト	後ろ。背中のほう。時間がたってから。残り。
アトアジ	食べ終わったのちに、口の中に残る風味。
アトシマツ	物事をやったのち、きれいに整えること。
アトツギ	前の代の仕事を継承すること。
アトマワシ	物事をすぐその場でしないで、他のことを先にすること。
アナ	表面よりくぼんでいる部分。
アナウメ	へこんだ所を平らにすること。「○○○○問題」
アナタ	相手の人を指す言葉。
アニ	自分より年上の男の兄弟。
アニキ	年長者や先輩を呼ぶ言葉。古い方の食べ物。
アネ	年上の女のきょうだい。
アバラボネ	胸をかこむ骨。ろっ骨。
アパート	たくさんの家族が住めるように住む部屋を区切っている大きな建物。
アヒル	マガモを家畜として飼いならしたもの。
アピール	英語で訴えること。何かを主張して人々に呼びかけること。
アフリカ	地中海の南にあって、サハラ砂漠がある大きな大陸。
アブ	ハエに似ているが、ハエより少し大きい昆虫。
アブラ	植物や油田などから取れる、食用や燃料にする液体。
アブラアセ	苦しいとき、痛いときなどにじっとりかく。
アブラナ	春、黄色の花をさかせ、種からバイオ燃料が取れる植物。
アベコベ	順序や位置や関係が反対であるさま。
アマガサ	雨が降るときにさす傘。
アマクチ	スイートな味。
アマグモ	降水をもたらす灰色の乱層雲。
アマザラシ	物を雨にさらしてしまうこと。
アマチユア	英語で素人のこと。
アマド	雨や風などを防ぐために窓の外側に備え付けのシールド。
アマノガワ	よく晴れた夜、白く光って川のように見える星の集まり。
アマモリ	雨が、屋根や壁などを伝わって部屋の中に落ちてくること。
アマヤドリ	雨がすむまで、雨のかからない場所でしばらく待つこと。
アマリ	割り算で割り切れずに残った数。
アミ	糸などを編んで作ったもの。
アミモノ	糸や毛糸などを使って編むとできる。
アメ	大気中の水蒸気が冷やされて水のしずくになって落ちてくるもの。
アメリカ	太平洋と大西洋にはさまれた大陸。
アメンボ	池や小川にすみ、水の上を長い足ですべるように動く昆虫。
アヤトリ	輪にした糸を指や手首にかけていろんな形を作る遊び。
アユミ	ウォーキング。物事の進み具合。
アライモノ	洗わねばならない衣類や食器など。
アラウミ	波の荒れ狂う海。
アラカジメ	前もって。前から。
アラケズリ	細かいところは気にしないでざっと仕上げること。
アラシ	はげしくふきあれる風。はげしい雨風。
アラスジ	小説や物語の概略。
アラレ	もちを小さく切って味をつけて、焼いたり干したりした食べ物。
アラワ	むき出しでかくされていない様子。
アラワレ	かくれたものが外に出てくること。
アリ	黒く小さな昆虫。「○○ジゴク」は○○の天敵。
アリカ	物のある場所。
アリカタ	あるべきすがた。
アリガトウ	感謝やお礼の気持ちを表す言葉。
アリガネ	手元にある現金。
アリサマ	物事の様子。
アルガママ	なるようになれ。
アルジ	一家の中心になる人。やとい主。所有者。
アルバイト	本職の片手間にする仕事。
アルバム	記念のための写真帳。
アルミ	○○○ニウムの略。軽い金属で元素記号Al。
アレ	話し手が自分・相手のどちらからも遠く離れた物を指す言葉。
アレコレ	○○や○○や。色々な事や物。
アレモヨウ	天気などが悪くなりそうな様子。争いなどが起こりそうな様子。
アワ	液体が空気を含むとできる丸いつぶ。
アワレ	深く心を動かされる感じ。みじめなさま。
アン	意見。考え。プラン。
アンカー	船のいかり。リレーにおいて最後の人。
アンキ	言葉などをそのまま覚え、すぐに思い出せるようにすること。
アンギヤ	修行などの目的を持って諸国を回り歩くこと。
アンケート	大ぜいに同じ質問をして、全体の考えや様子を調べること。
アンゴウ	他の人にわからないように決めた秘密の記号や文字列。
アンザン	書いたり道具を使ったりしないで、頭の中で計算すること。
アンシツ	光が中に入らないようにした暗い部屋。
アンシン	心配ごとがなく、安らかであるさま。
アンジ	それとなくわからせること。ヒント。
アンジユウ	落ち着いて住んでいること。
アンセイ	体も心も静かにしておくこと。
アンゼン	危なくないさま。
アンテイ	物事が落ち着いて、変化が少ないこと。
アンテナ	電波を出したり受けたりする線。
アンナイ	場所が分からない人を導いていくこと。
アンパン	中に黒い小豆のペーストなどが入っているお菓子。「○○○○マン」
アンピ	無事かどうか。変わりなく暮らしているかどうか。
アンペア	電流の強さの単位。フランスの物理学者の名にちなむ。
アンマ	体を手でさすったり、もんだりして筋肉のこりをほぐす療法。
アンミツ	甘いものに甘いものを加えた飛び切り甘いものです。
アンミン	ぐっすり眠ること。
アンモニア	鼻を強く刺激する、肥料の原料の気体。
アンヨ	幼児語で歩くこと。
イイダコ	小型のタコ。軟体動物。
イイツタエ	昔からずっと人から人へ、言葉で伝えてきたこと。
イイナズケ	婚約者。フィアンセ。
イイネ	売る人が決めた値段。
イイン	団体などで大事な仕事やみんなの世話をまかせられた人。
イエ	人が住むための建物。
イエキ	胃のかべから出てくる、食物を消化するための強い酸性の液体。
イエス	英語で「はい、その通り」という意味の言葉。肯定。
イエデ	自宅を抜け出し、どこかに行ってしまって帰らないこと。
イエロー	英語で黄色のこと。
イオン	電気をおびた原子や分子。
イカ	数や量などが示した値よりも下であること。タコではない。
イカダ	木や竹を何本も組んで水の上に浮かぶようにした乗り物。
イカメラ	胃の中に入れる小さなカメラ。
イガイ	思いがけないこと。予想もしなかったこと。
イガク	人間の体のはたらきや病気について研究する学問。
イガグリ	とげとげが付いたままのクリの実。
イキ	動物が口や鼻で吸ったりはいたりする空気。
イキオイ	活動力。勢力。その場のなりゆき。
イキカエリ	往復。死んでいたのに復活？
イキカタ	生活の方法。人生の選び方。
イキガイ	生きている喜び。生きている値打ち。
イキキ	往復。行ったり来たり。
イキギレ	呼吸が苦しくて、ハアハアすること。
イキサツ	そのようになった理由。なりゆき。
イキヅカイ	呼吸の仕方。
イキドオリ	怒ること。腹を立てること。
イキドマリ	行く手がふさがっていて、その先に行けないこと。
イキヌキ	仕事の途中で一休みすること。
イキノコリ	命をとりとめてこの世に残ること。または、その人々。
イキモノ	生きている物。生命のあるもの。せいぶつ。
イギ	ちがった意見。異論。
イギヨウ	すぐれた事業や実績。
イギリス	ヨーロッパの北西部に浮かぶ島国。首都はロンドン。
イクジ	子どもを育てること。
イクセイ	育てて立派にすること。
イクツ	個数や年齢をたずねるときに使う言葉。どれだけ。
イクラ	サケやマスなどの卵をほぐして塩づけにした食べ物。
イケ	土地がくぼんでいて、水のたまった所。
イケドリ	生きたままでつかまえること。
イケバナ	草木・花の形を整えて花びんなどにさすこと。
イケン	ある事がらに対する考え。
イゴ	碁盤の上にたがいに白と黒の石を置いていく遊び。
イゴコチ	ある場所や地位にいるときの気分や感じ。
イサイ	きわだってすぐれたありさま。「○○○を放つ」
イザカヤ	店先で気軽にお酒を飲ませる店。
イシ	手で持てるくらいの岩の小さいもの。
イシアタマ	固くて丈夫な頭部。
イシガキ	家の周りなどに石を積んで作ってある、かべや塀。
イシキ	自分のやっていることや周りの物がわかる心のはたらき。
イシツ	性質がちがっていること。
イシヘン	漢字で「破」「研」の左側にある部首。
イシヤ	病気の診察や診療を職業にする人。医師。ドクター。
イシヨウ	芝居などで出演者が着る衣服。
イジ	根性。強い意志。無理やりでもやりとげようとする心。
イジユウ	よその土地に移り住むこと。
イジユツ	傷や病気をなおす技術。
イジワル	他人をわざと困らせてやろうとするさま。
イス	こしかけ。座る物。地位。
イズミ	地下水が自然にわき出ている所。または、その水。
イセイ	元気のあること。敵をおそれさせる力や勢い。
イセキ	昔、建物などがあった場所。歴史的な物が残っている場所。
イゼン	それより前。むかし。もともと。
イソ	海の波打ち際。岩の多い海岸。「○○ジン」はうがい薬。
イソギ	急用。急を要すること。
イソギアシ	速めに歩くこと。
イタ	うすく平たい形をしたもの。とくに木を平たく切ったもの。
イタズラ	ふざけて、人がこまることやいやがることをむりにすること。悪ふざけ。
イタチヨコ	平たい○○状の○○○レート。お菓子。
イタバサミ	対立しているものの間で、どちらにも味方することができず、迷い、苦しむこと。
イタミ	体が感じる痛い感じ。
イタリア	ヨーロッパの南にある、地中海につき出た半島の国。
イタワリ	やさしく世話をしたり、なぐさめたりする。
イチ	ある物・人・事がらが、しめている場所。地点。
イチガツ	一年で最初の月。
イチゲキ	一回の打撃・攻撃。
イチジ	今より前のある時。その時。しばらく。
イチダイジ	とても大変な出来事。
イチダン	次の高さまでの差。程度が進むさま。
イチド	一回。いっぺん。
イチドウ	居合わせるもの全員。みんな。「○○○○礼」
イチナン	一人の男の子。長男。
イチネン	十二ヶ月。三百六十五日。
イチバ	たくさんの商人が集まって物を取り引きする場所。
イチバン	いろいろな物や人の中で最もすぐれているもの。
イチブ	全体の中のある部分。
イチブブン	全体を分けたものの一つ。一部。
イチマイ	紙や板などの平べったい物の一つ。
イチメン	辺り一帯。新聞の最初のページ。「○○○○の銀世界」
イチヤ	一晩。夜が明けるまで。
イチヨウ	食べ物をたくさん食べたときにもたれます。
イチリユウ	その道で最もすぐれていること。
イチルイ	野球で走者が最初にふむ塁。
イチレツ	ひと並び。「○○○○に並ぶ」
イツカ	はっきりしないある時を表す言葉。
イツカイ	一度。ひとたび。
イツキ	休みを入れずに一回でやりとげること。
イツキヨク	音楽のまとまった作品の一つ。
イツク	一つの俳句。
イツケン	一度見ること。ちょっと見ること。見た目には。
イツコ	ひとつ。
イツコウ	いっしょに行く人。同行者。
イツコク	一つの国。国じゅう。
イツシユ	同じタイプのものの中の一つ。
イツシユウ	一回り。ひとめぐり。
イツシユン	まばたきをするほどの短い時間。あっという間。
イツシヨ	一つにまとまること。ひとまとめ。離れないこと。
イツシヨウ	生まれてから死ぬまでの間。
イツシン	二人以上の人が心を一つにするさま。「○○○○同体」
イツセイ	みんなそろって同時に。いっしょに。
イツセキ	一つの石。「○○○○二鳥」
イツセツ	一つの見解。
イツセン	ひと勝負。「○○○○を交える」
イツチ	ぴったり合うこと。
イツチヤク	競走や競泳などで一番早くゴールに着くこと。
イツツ	一つの五倍。五歳。
イツテ	碁や将棋で石やこまを一つ動かしたりすること。
イツテキ	ひとしずく。
イツテン	品物一つ。「紅○○○○」
イツトウ	第一。最上。「○○○○賞」
イツトキ	わずかな時間。しばらくの間。
イツパイ	茶わん・コップなどの一つ分の量。たくさん。
イツパツ	鉄砲を一回撃つこと。
イツパン	ふつうのこと。多くの場合に当てはまること。
イツピン	ひとしな。
イツプウ	他とちがった一種のおもむき。「○○○○変わった人」
イツペン	一回。一度。同時に。
イツポ	ひとあし。
イツポウ	ある決まった一つの方向。片方。
イツポン	棒状のものの一つ。技が一回決まること。
イツモ	ふだん。いつでも。常に。
イテン	建物などの場所を変えること。引っこし。
イデン	生物の形や特徴などが親から子へ受け継がれること。
イト	あることをしようと考えること。または、その考え。
イトコ	父や母の兄弟や姉妹の子ども。
イトナミ	商売。なりわい。勤め。
イトヘン	「紙」「組」「線」などの漢字の左側の部首。
イトマキ	ギターやミシンについています。
イド	地下深く穴をほって地下水をくみ上げられるようにしたもの。
イドウ	場所を移し変えること。
イドコロ	いる場所。「○○○○をつかむ」
イドバタ	井戸のまわり。「○○○○会議」
イナ	相手の言うことを打ち消すときに使う言葉。
イナイ	ある決められた数や時間、量よりも小さいこと。
イナカ	都会からはなれ、緑が多く、人口が少ない所。
イナサク	イネの栽培。米作り。
イナズマ	かみなりの光。
イナリズシ	油あげの中にすしめしをつめた食べ物。
イニシエ	むかし。
イヌ	肉食のほ乳類。人に飼われ、利口で鼻のきく動物。
イヌカキ	頭だけを出して手で水をかきながら進む泳ぎ方。
イネ	米を作るために植えられる草。
イネムリ	すわったり、腰かけたりしながら眠ってしまうこと。
イノシシ	よく突進する野生の豚。
イノチ	生命。生きている間。
イバシヨ	存在している所。
イビキ	ねているときに、口や鼻から息といっしょに出る音。
イフク	身に付ける衣装。
イブクロ	食道の次に食べ物が入る器官です。
イブツ	体内や食べ物などの中にまぎれこんだ、体や食べ物などとは別の物。
イヘン	変わった出来事。変化。
イベント	出来事。行事。事件。
イマ	ちょうど、この時。
イミ	言葉や文や記号が表す事がらや内容。理由や意図。
イミン	そこで働くために外国に移り住むこと。または、その人。
イメージ	心の中にえがく姿。
イモ	地下のくきや根に、デンプンなどをたくわえて、太くふくらんだもの。
イモウト	年下の女のきょうだい。
イヨウ	ふつうとはちがった様子。
イヨク	何かをなしとげようとして、はり切る気持ち。
イライ	他の人に用事や仕事をたのむこと。
イリグチ	入る所。エントランス。
イリタマゴ	卵を調理して味付けした食べ物。
イリマメ	大豆などをまんべんなく加熱したもの。
イリヨク	人をおそれさせ、おさえつけたり従わせたりする強い力。
イルカ	犬と同じくらい賢い、海に群れになって生きる動物。
イルス	家にいないふりをすること。
イレイ	いつもとはちがうこと。「○○の対応」
イレバ	抜けたり欠けたりした歯の代わりの、人工的に作られた歯。
イレモノ	物を収めるうつわ。容器。
イロ	赤・黄・青など、物で反射する光に感じられる種類。
イロオトコ	きれいな男。美男子。
イロツヤ	色調と光沢。
イロメガネ	サングラスを日本語でいうと……。
イロワケ	カラフルに区別すること。
イロン	他の考えや意見。「○○○は認めない」
イワ	動かすことができないほどの、大きな石。
イワイ	めでたいことを喜ぶこと。
イワイゴト	喜ぶべきこと。喜びの行事。
イワシ	海にすむ小さな魚。背中は青緑、腹は銀色で、青黒いまだらがある。
イワバ	山の表面に岩石が多くある、けわしい場所。
インカ	火や熱によって火が付く。
インカン	木や石、動物の角などに名前をほった物。はんこ。
インサツ	文字や絵、写真などを紙に刷ること。
インシユ	お酒を飲むこと。
インシヨウ	見たり聞いたりして、心に残ったこと。
インシヨク	食べ物を食べたり、飲み物を飲むこと。
インセイ	病原菌があるという反応が現れないこと。
インセキ	流れ星が大気中で燃えつきないで、地面に落ちてきた物。
インゼイ	発行者が著作権の使用料として著作権者に支払うお金。
インタイ	仕事をやめたり、地位を退いたりすること。
インテリ	多くの知識を持った人。知識人。
インド	アジア南部の、インダス川とガンジス川が流れる国。
インフレ	通貨価値が下がり、物価が上がり続ける現象。
インヨウ	他人の言葉や文章を、自分の話や文章で使うこと。
インリヨク	物体がたがいに引き合う力。
ウイスキー	大麦から作る、アルコール分の高いお酒。
ウインク	合図のために片目でまばたきをすること。
ウイーク	英語で一週間のこと。
ウエ	より高い所。
ウエキ	庭や公園などに植えてある樹木。
ウエルカム	英語で歓迎を表す言葉。ようこそ。
ウオイチバ	魚介類を取り引きする市場。
ウオン	韓国の貨幣単位。
ウカ	昆虫のさなぎが成虫になって、羽がはえること。
ウカイ	遠回りすること。
ウガイ	水や薬などで、のどや口をすすぐこと。
ウキ	体などが浮かぶこと。体などを浮かす物。
ウキクサ	池や田んぼに浮かぶ緑色の植物。
ウキシズミ	浮いたり沈んだりすること。
ウキブクロ	中に空気を入れ、水中で体を浮かばせるのに使う袋。
ウクレレ	ハワイの原住民が愛用する小型の弦楽器。
ウグイス	「ホーホケキョ」と美しい声で鳴く小鳥。
ウケ	評判。人気。
ウケツケ	用事のある人を適切な場所に案内する人。受理すること。
ウケミ	柔道で相手に投げられたときにけがをしないように倒れるワザ。
ウゴキ	運動。行動。成り行き。
ウサギ	耳が長く、後ろ足が大きい動物。
ウシ	体が大きく、力の強い動物。古くから家畜として飼われている。
ウシロ	物の正面・前面とは反対の方。
ウシロアシ	動物や昆虫の尻に近い方の足。
ウジ	血筋のつながり。みょう字。
ウスギ	衣服を少なく着ること。
ウスクチ	味や色が薄いもの。
ウズ	ぐるぐると動く風や水。
ウズマキ	ぐるぐると回る形や模様。
ウセツ	道や進む方向が右へ曲がること。
ウタ	声を出して、節をつけて歌う言葉。
ウタイテ	歌手。シンガー。
ウタタネ	寝どこではない所でうとうとと眠ってしまうこと。
ウタヒメ	歌をうたう女。女性歌手。
ウチ	中の方。家。自分が活動している所。
ウチアワセ	前もって相談すること。
ウチガワ	内部。
ウチボリ	城の内部にある人工の池。通行を妨害する。
ウチミズ	ほこりを静めたり、すずしくするために、道路や庭に水をまくこと。
ウチユウ	地球や太陽や、他のすべての天体を含んだ、はてしない空間。
ウチワ	柄の付いた、あおいで風を起こす道具。
ウツシ	複製した文書や絵。コピー。
ウツリ	光や影があらわれること。「テレビの○○○が悪い」
ウツリガ	別の物に、においが取り込まれること。
ウツロ	気がぬかれたように、ぼんやりしているさま。
ウツワ	入れ物。容器。才能。
ウテン	雨降りの空。雨が降る日。
ウデ	肩から手首までの部分。
ウデグミ	両方の腕を胸の前で組み合わせること。
ウデズモウ	二人が手のひらを握り合って、相手の手の甲を台に付くまで押し倒す遊び。
ウデマエ	物事をうまくやる技術や能力。
ウデマクリ	そでをまくり上げること。
ウドン	めん類の一種。ラーメンやそうめんよりも太い。
ウナギ	ぬるぬるしてつかみにくい細長い魚。
ウニ	丸い体に多数のとげのはえている海の生き物。
ウバグルマ	幼児を乗せる、四輪の手押し車。
ウブゲ	やわらかい毛。
ウマ	体が大きくて、首と足が長い、足の速い動物。
ウマノリ	騎乗すること。
ウマミ	うまい風味。商売の利益。
ウマレツキ	先天的に持っている性質。天性。
ウミ	塩水でおおわれた場所。船が走る場所。
ウミガメ	浦島太郎を竜宮城に案内した動物。
ウミビラキ	海水浴場で、その年初めて水泳などを公式に許すこと。またはその日。
ウミベ	波しぶきが聞こえる場所。
ウメ	○○干しや○○酒を造る原料の果実。
ウメシユ	何かの果実を焼酎につけて作ったお酒。
ウメボシ	何かの実をシソの葉と共に塩づけにした、すっぱい食べ物。
ウモウ	鳥のやわらかな羽や毛。
ウラ	写真や絵などで、何も写っていない方の面。表の反対の面。
ウラカタ	目立たない所で仕事をする人。
ウラガワ	表ではない方。反対の方。
ウラゴエ	普通の音域をこえた高音部を技巧的に歌う声。
ウラヅケ	確かな証拠。
ウラナイ	何らかの印によって未来や運勢などを判断する宗教的な行為。
ウラヤマ	建物の後ろにある、土が盛り上がった場所。
ウリアゲ	品物を売って得たお金の総額。
ウリダシ	発売開始。発売中。「大○○○○」
ウリテ	品物を販売する人。
ウリネ	販売価格。
ウリバ	品物などを販売する場所。
ウリモノ	商品。
ウリヨウ	地表に降った雨の量。降水量。
ウルオイ	しめりけ。
ウルシ	さわるとかぶれることがある落葉樹。または、その樹液からできた塗料。
ウレシナキ	感激して泣くこと。
ウレツコ	人気があって、特にもてはやされる人。
ウレノコリ	残った商品。
ウレユキ	品物の販売状況。
ウロコ	魚類やは虫類などの体の表面を覆う小さなうすい物。
ウワガキ	物の上に文字を書くこと。
ウワキ	愛情が他に移りやすいこと。気まぐれで異性と交わること。
ウワギ	上半身の一番外側に着る物。
ウワゴト	はっきりとした意識を持たないで、口走る言葉。
ウワサ	世間の評判。面白がって伝える不確かな話。
ウワテ	土地の高い方。よりすぐれている方。
ウワバキ	土足禁止の場所で使うスリッパなど。
ウン	めぐり合わせ。ラッキー。
ウンエイ	決まりや仕組みを使って、物事を取り運ぶこと。
ウンガ	陸地を掘って船が通れるようにした水路。
ウンキユウ	乗り物の営業を休むこと。
ウンコウ	決められた道を進んで行くこと。
ウンソウ	人や品物を、ある場所から他の場所に運び移すこと。
ウンテン	乗り物や大きな機械を動かすこと。
ウンドウ	体操やスポーツなどで体を動かすこと。
ウンメイ	人の成り行き。めぐり合わせ。
ウール	英語で羊毛のこと。
エア	英語で「空気」のこと。
エイエン	いつまでも限りなく長く続くこと。
エイカイワ	英語を使って話すこと。
エイカク	直角よりも小さな角。
エイガ	連続したイメージをスクリーンに映し出し、映像を見せるもの。
エイキユウ	いつまでも絶えることなく続くこと。
エイキヨウ	一方の働きが他に及んで、変化や反応が起こること。
エイギヨウ	儲けるためにする仕事。
エイコウ	輝かしい名誉。
エイコク	イギリス。
エイゴ	イギリスやアメリカなどで広く使われている言語。
エイサイ	生まれつき持っている優れた能力。「○○○○教育」
エイセイ	病気にならないように、食事や身の回りを清潔に保つこと。
エイゾウ	光によって映し出された物の姿。
エイチ	すぐれた判断力。アルファベットの8番目の文字。
エイト	英語で8のこと。
エイブン	Englishで書かれた文章。
エイユウ	知恵も力もすぐれた、りっぱな人。
エイヨウ	生物が生きていくために必要な成分や、それを含む食べ物。
エカキ	絵画を描く人。
エガオ	笑った顔。
エキイン	鉄道の停車場の仕事をする人。
エキタイ	水や油などの、体積は変わらないが、形が入れ物によって変わる物質。
エキチヨウ	鉄道の停車場の長。
エキベン	鉄道で売っている弁当。
エクボ	笑ったときに、ほおにできる小さなくぼみ。
エサ	動物を飼ったり、とらえたりするために使う食べ物。
エジプト	ピラミッドやスフィンクスのある、アフリカ北部の国。
エダ	植物のくきが分かれて成長した部分。
エチケツト	おたがいに気をつけないといけない、言葉づかいや動作の決まり。
エツラン	本や資料を見たり調べたりすること。
エド	現在の東京にあった、○○時代の都市。
エニツキ	その日の出来事を絵と共に記したもの。
エネルギー	物体が他の物にはたらきかける力。活動するもととなる力。
エノグ	絵画などで色を付けるために塗る材料。
エハガキ	厚紙の郵便物の裏に絵や写真を印刷したもの。
エビ	硬い殻におおわれ、十本の足と、長い触角を持つ動物。
エプロン	英語で西洋風の前掛けのこと。
エホン	小さい子どものために、絵を主にしてかかれた読み物。
エモノ	狩りや漁でとった魚や鳥などのこと。
エラ	魚などが水中生活するための動物の呼吸器。
エリ	衣服の首の周り。
エリア	区域。「サービス○○○」
エリート	特に優れた一部の人。
エンカ	日本調のこぶしを利かせた歌謡曲。
エンカイ	人が集まって飲食をして楽しむこと。酒盛り。
エンカク	遠く離れていること。「○○○○操作」
エンガイ	海水や潮風の塩分によって農作物・建造物などが受ける被害。
エンガン	川や海などの岸に沿った陸地。
エンキ	決めていた日を延ばすこと。
エンギ	見物人の前で、芸や技を演じて見せること。
エンケイ	円い形。「○○○○脱毛症」
エンゲイ	花や野菜を作ること。
エンサン	塩化水素が水に溶けたもの。無色透明で強い酸性を示す。
エンシユウ	円い形をしたものの周りの長さ。「○○○○○率」
エンジ	保育施設の子ども。
エンジヨ	困っている人や国に力を貸したり、お金をあげて助けること。
エンジヨウ	燃え上がること。転じてSNSで反対意見などが一気にあふれること。
エンジン	自動車・飛行機・船などを動かすもととなる装置。
エンゼツ	大勢の前で、自分の意見を述べること。
エンソ	黄緑色で刺激臭のある気体元素。漂白剤や消毒剤に使われる。
エンソウ	音楽をかなでること。
エンソク	体を鍛えたり、見学をするため、日帰りで遠くに出かけること。
エンダカ	為替相場で外国通貨に対する￥の価値が高いこと。
エンダン	結婚や養子縁組の話の持ちかけ。
エンチユウ	円い柱のような立体。
エンチヨウ	決められた長さや時間を延ばすことや延びること。
エントツ	物が燃えやすいように、空気を取り入れ、煙を外に出すための長い筒。
エンバン	円く平らな形の物。ディスク。
エンピツ	木と炭と粘土で作った、字を書くための道具。
エンブン	物に含まれている塩気。
エンムスビ	男女の縁を結ぶこと。結婚。
エンヤス	為替相場で外国通貨に対する￥の価値が安いこと。
エンリヨ	行いや言葉づかいをひかえめにすること。
オアシス	砂漠の中で、水がわいて木が茂っている場所。
オイウチ	逃げていく者を追いかけて、やっつけること。
オイカゼ	後ろから吹く風。
オイスター	海のかきを英語でいうと……。
オイル	英語で油のこと。
オウ	国の最高権力者。君主。
オウイ	国王の位。
オウエン	拍手をしたり、声をかけて選手をはげますこと。
オウカン	王様がかぶるのは……。
オウキユウ	王様の住む場所は……。
オウギ	あおいで風を起こす道具で、折りたたむことのできるもの。
オウケ	王の一族。または、その家筋。
オウコク	国王が治めている国。
オウゴン	ゴールド。
オウジ	王様の男の子。
オウセツ	人をむかえて相手をすること。
オウセツマ	客が来たときに通す部屋。
オウタイ	相手になって受け答えをすること。
オウダン	横切ること。
オウテ	将棋で相手の王将を直接攻め立てる手。
オウトウ	きかれたことに答えること。受け答え。
オウフク	行きと帰り。
オウヘイ	えらそうにして、人を見下すさま。
オウベイ	ヨーロッパとアメリカ。
オウボ	募集に応じて申し込むこと。
オウム	美しい羽と、太く曲がったくちばしを持ち、人の言葉をまねる鳥。
オウヨウ	前から持っている知識や理屈を実際にあてはめて使うこと。
オウリヨウ	他人の物や公共の物を不法に自分の物にすること。
オウレンズ	真ん中が周りより、うすいレンズ。
オオアタリ	予想がぴたりと的中すること。
オオアメ	大量の降雨。
オオアワテ	心の平静さを失い、非常にまごまごすること。
オオイ	物の上からかぶせて隠すこと。物の前にかけて隠すこと。
オオイソギ	非常に急を要すること。
オオオトコ	がっしりした男性。
オオカミ	犬の仲間のけもの。
オオガタ	大きな型。同じものの中でも大きいこと。
オオキサ	サイズの大小。
オオゴエ	やかましい発声。
オオゴト	めったにない重大な事。
オオゼイ	たくさんの人の数。
オオソウジ	建物全体をていねいに掃除すること。
オオドウグ	演劇で使用する舞台装置。また、それを扱う係。
オオドオリ	町なかを通る幅の広い道。
オオミソカ	一年の最後の日。十二月三十一日。
オオモジ	大きな文字。大きな形の字の種類。
オオモノ	ある分野の実力者。
オオモリ	食べ物をふつうより多く容器に盛ること。
オオヤケ	国・政府・役所のこと。世間のこと。世間に知られること。
オカ	山ほどは高くなく、なだらかに盛り上がっている土地。
オカアサン	母。ママ。
オカエシ	物をもらったお礼に他の物を贈ること。
オカゲ	人から受けた恩恵。神仏の加護。
オカツパ	前髪をまゆの上で、後ろ髪をえりもとで切りそろえる髪型。
オカルト	神秘的・超自然的な現象。
オカワリ	同じ物を続けて二回以上飲んだり食べたりすること。
オカン	全身がぞくぞくとする寒け。
オキ	海や湖などで、岸から遠くはなれた場所。
オキテ	決まりごと。定め。
オキニイリ	すごく好みの人や物。
オキバ	物を配置する場所。
オキマリ	いつも変わらないこと。
オキモノ	かざりとして置いてある物。
オク	一万の一万倍。
オクガイ	建物の外。
オクサマ	よその家の妻を敬って言うときの言葉。
オクジヨウ	建物の一番上の、平らになっている所。
オクソク	根拠もなくいいかげんに推測すること。当て推量。
オクナイ	建物の中。
オクバ	口の奥のほうにある、うすのような形の歯。
オクビヨウ	小さいことにもびくびくして、怖れること。
オクリガナ	漢字と仮名で言葉を書き表すときに、漢字の後につける仮名。
オクリモノ	他人にあげる品物。プレゼント。
オケ	板を円筒形に組み合わせて、底を付けた器。
オコナイ	すること。ふるまい。
オサガリ	目上・年上の人からもらった使い古しの衣服や品物。
オサライ	教わったことが身に付くように自分でもう一度やってみること。
オシイレ	ふすまや戸でしきった、物を収納する場所。
オシエ	教育。教訓。教義。
オシエゴ	教育した生徒・学生・弟子。
オシダシ	相手を力ずくで外に出すこと。相撲のわざの一つ。
オシボタン	指で押さえることで電気回路を開閉できるボタン。
オシボリ	顔や手をふくために、小さなタオルなどを湯や水でぬらしてしぼったもの。
オシヤベリ	口数が多いこと。
オシヤレ	顔や身なりをかざるさま。きれいな着物を着たり、化粧をすること。
オジ	父や母の男の兄弟。
オジイサン	祖父を敬い、親しんで言う言葉。
オジギ	頭を下げて、あいさつや礼をすること。
オジサン	父や母の男の兄弟を親しんで言う呼び名。子どもが大人の男の人を指して言う言葉。
オスソワケ	よそからもらった物を、さらに別の人に分けること。
オセチ	正月・五節句などに作る特別な料理。「○○○料理」
オセツカイ	でしゃばって余計な世話をやくこと。
オソザキ	同種のものより遅れて咲くこと。
オソレ	怖いと思うこと。
オソロイ	衣服やその柄が同じであることを丁寧にいう言葉。
オタガイ	双方。自分と相手。
オタク	趣味や玩具にひどく傾倒する人。
オタケビ	勇ましい叫び声。
オチツキ	気持ちが静まること。おさまりがよいこと。
オチバ	落ちている葉っぱ。
オチヤ	仕事の合間のひと休み。「○○○にしよう」
オツカケ	追いかけること。追いかけてくる熱狂的なファン。
オツゲ	神仏が人間に意思や預言などを告げ知らせること。
オツテ	逃げていく人を追いかける人。
オツト	結婚した男女のうち、男の人を指して言う言葉。
オツリ	商品の金額と支払った金額の差額。
オテアゲ	解決の手だてがなくて、どうにもならなくなること。
オテダマ	小さな麻袋に小豆などを入れてぬったもの。またはそれを使った遊び。
オテモト	料理店などで、お客が使う箸の丁寧語。
オテンバ	若い女性が元気よく、活発に動き回ること。または、そのような人。
オデコ	ひたい。
オデン	ダイコン・コンニャク・ちくわなどを薄味のだし汁で煮込んだ料理。
オト	空気を伝わって、音波によって耳に伝わるひびき。
オトウサン	父を敬い、親しんで言う言葉。
オトウト	年下の男の兄弟。
オトコ	人間の性別で、女でない方。
オトコナキ	男性が感情を抑えきれずに泣くこと。
オトコマエ	男性としての容姿がよいこと。またはそのような人。
オトシダマ	新年を祝って、子どもに送るお金や物。
オトシブタ	なべの中に入れて材料の上に直接のせるふた。
オトシモノ	気が付かないで金品を落とすこと。または、その金品。
オトズレ	訪問。到来。
オトトイ	昨日の前の日。
オトトシ	昨年の前の年。
オトナ	十分成長し、一人前になった人。成人。
オトヒメ	浦島伝説で竜宮城に住むという美しい姫。
オトメ	年の若い、結婚していない娘。
オトモ	目上の人などに付き従っていくこと。または、その人。
オドリ	音楽や歌に合わせて体を動かして、何かを表現する。
オドリコ	女性ダンサー。
オドロキ	びっくりすること。サプライズ。
オナイドシ	年が同じこと。
オナカ	腹の辺り。
オニイサン	年長の男性に呼びかける言葉。
オニオン	英語でたまねぎのこと。
オニギリ	ご飯を丸や三角ににぎったもの。おむすび。
オニゴツコ	子どもの遊びの一つ。一人が鬼になって他の人を追いかける。
オネエサン	年長の女性に呼びかける言葉。
オノ	木を割ったりするのに使う道具。
オノレ	自分自身。相手を見下して言う言葉。おまえ。
オハジキ	貝や小石やガラスなどを指ではじく遊び。
オハヨウ	親しい人や目下の人に朝初めて会ったときに言うあいさつ。
オバ	父や母の女のきょうだい。または、叔父や叔母の妻。
オバアサン	祖母を敬い、親しんで言う呼び名。
オバケ	幽霊。妖怪。見た目が異常なこと。
オバサン	子どもが大人の女の人を指して言う言葉。
オヒサマ	太陽を親しんで呼ぶ言葉。
オヒタシ	青菜などをゆでで、しょうゆやかつおぶしなどをかけた食べ物。
オヒヤ	冷たい飲み水。冷や飯。
オヒル	ランチ。昼食。
オビレ	魚の体の後ろ端にあるひれ。
オボエ	記憶。「身に○○○がない」
オボロヅキ	ぼんやりとかすんで見える春の夜の月。
オマエ	親しい人、目下の人を指す言葉。
オマケ	景品をつけたり、値引きをしたりすること。
オマモリ	わざわいをよけるために身に付ける守り札。護符。
オマワリ	巡査のこと。警察官。
オミクジ	神社や寺で引いて吉凶を占う。
オメイ	悪い評判。不名誉。「○○○を返上する」
オメデトウ	新年やうれしいことをたがいに祝い合うあいさつの言葉。
オモイツキ	ある考えがふと心に浮かぶこと。または、その考え。
オモイデ	過ぎ去った出来事を、後から思い出すこと。
オモイヤリ	相手の立場になって考える心。
オモカゲ	記憶や心の中に残っている姿。
オモサ	重量。
オモシ	物を上から押さえつけておくための物。
オモチヤ	子どもが遊ぶ道具。
オモテ	二つの面のうち、主に使われる方、外からよく見える方の面。
オモニ	重たい荷物のこと。
オモムキ	風流でおもしろい感じ。しみじみした様子。
オモリ	軽い物に重みを加えるために付ける物。
オモワク	自分の考えや計画。
オヤ	子を育てる人、育てた人。父や母。
オヤカタ	職人などの頭。職人などを敬い、親しんで呼ぶ言葉。
オヤコ	保護者と子。「○○○丼」
オヤゴコロ	子を愛する保護者の心。
オヤツ	午後の間食。午後三時。一般に間食。
オヤバナレ	子どもが成長して自立するようになること。
オヤフコウ	子が保護者に苦労や迷惑をかけること。または、そのような子。
オヤユビ	手足の五本の指の中で一番太い指。
オランダ	北海に面している、西ヨーロッパの国。
オリアイ	妥協。譲り合って解決すること。「○○○○が付く」
オリオン	中央に三ツ星が並ぶ、代表的な冬の星座。「○○○○座」
オリカエシ	折り曲げた部分。引き返すこと。すぐに。
オリガミ	色の付いた四角い紙を折っていろんな形にすること。または、その紙。
オリコミ	新聞・雑誌などの間に広告のビラや付録を折ってはさみ込むこと。
オリジナル	他に例がなく、目新しい。もとの作品。
オリタタミ	折って小さくすること。
オリヅル	折り紙を折りたたんで、鶴の形にしたもの。
オリメ	ものを折りたたんだときにできる境目のすじ。
オリモノ	糸を縦横に組み合わせて作った布。
オルゴール	ぜんまい仕掛けで自動的に一定のメロディーを演奏する装置。
オレイ	「礼」の丁寧語。感謝の言葉を表すこと。
オレンジ	みかんの仲間の果物。だいだい色。
オロシウリ	問屋が仕入れた商品を小売店に売り渡すこと。
オワライ	客を笑わせるための出し物。特に落語や漫才。
オン	スイッチが入っていること。
オンイキ	人や楽器が発することのできる音の高低の範囲。
オンエア	番組が放送中であること。
オンカン	音に対する感覚。音の高低・音色などを聞き分ける能力。「絶対○○○○」
オンガエシ	受けた恩に報いること。
オンガク	音の高低・強弱・長短・音色などを組み合わせて作る、音の芸術。
オンキヨウ	音のひびき。「○○○○○効果」
オンケイ	利益や幸福をもたらすもの。めぐみ。
オンシ	教えを受けた、恩義のある先生。
オンシツ	植物などを育てるために、空気をさえぎって中をあたたかくした部屋や建物。
オンジン	恩のある人。世話になった人。「命の○○○○」
オンセイ	音や声。
オンセン	火山帯の地熱で地面の下からお湯がわき出ている所。または、そのお湯。
オンソク	音の伝わる速さ。非常に速い速度。
オンゾウシ	名門・名士の子息。
オンダン	気候が暖かくおだやかなこと。
オンチ	正しい音程で歌を歌えないこと。または、そのような人。
オンテイ	音の高さ。
オンド	物の温かさや冷たさの程度。
オンドリ	雄の鳥。雄のニワトリ。
オンナ	人間の性別で、男でない方。
オンパ	音の波。
オンプ	五線譜に記入して音の長さと高さを表す符号。
オンヨミ	漢字を音で読むこと。
オンリヨウ	音の大きさ。ボリューム。
オーエル	女性の会社員・事務員。
オーケー	よろしい。承知した。
オート	自動。自動式。
オートバイ	ガソリンで動く自動二輪車。単車。
オーナー	英語で所有者のこと。
オーバー	英語で度が過ぎるさま。決められた範囲を超えること。
オービー	その学校・職場にもともと所属していた人。先輩。
オープン	店などを新しく始めること。開かれていること。
オーロラ	北極・南極地方の高い空に現れる、放電による発光現象。
カイ	石灰質のからを持つ軟体生物の総称。
カイアク	物事を改めて、前よりもかえって悪くすること。
カイイン	会を構成している人。
カイウン	人生の道が開けて、幸運に向かうこと。
カイカ	花が咲くこと。
カイカイ	集会や会議などを始めること。
カイカク	古くなった仕組みや、よくないやり方などを改めること。
カイガ	線や色彩を使って平面上に描き出したもの。絵。
カイガイ	日本以外の場所のこと。
カイガラ	貝類の外側をおおう、石灰質の硬い殻。
カイガン	陸と海が接している所。海辺。
カイキユウ	組織などで定められている、身分・地位などの段階。
カイキヨ	素晴らしい行い。
カイキン	法律などで禁じていたことを解除すること。
カイギ	何人かが集まって話し合うこと。
カイギヨウ	行を改めること。
カイグン	海の防衛を主な任務とする軍隊。
カイケイ	お金の出入りを計算・記録すること。
カイケツ	問題になっていることがうまく片付くこと。
カイケン	人と会い、改まった話をすること。
カイコ	くわの葉を食べてまゆを作る益虫。
カイコウ	学校が新しく開設されること。
カイコク	外国との交流・通商を始めること。
カイサイ	会合や催し物などを開き行うこと。
カイサツ	駅の出入り口で乗車券などを検査・回収すること。またはその場所。
カイサン	会合・集まりをやめること。
カイシ	ある事を始めること。始まること。
カイシヤ	お金を出し合って作った営利団体。
カイシヤク	文章や物事の意味をわかりやすく説明することや理解すること。
カイシユウ	物品を寄せ集めること。
カイシヨウ	それまでにあった関係や約束などを取り消すこと。
カイジユウ	あやしいけもの。不思議なけもの。
カイジヨ	制限したり、禁止していたことを取りやめること。
カイジヨウ	催し物を開く場所。
カイスイ	海の水のこと。
カイスウ	物事を何度したか、何度起こったかの数。
カイセイ	空がすっきりと晴れ渡っていること。
カイセツ	ある事実について、よくわかるように詳しく説明すること。
カイゼン	物事の悪いところを改めて良くすること。
カイソウ	海に生えている草のような植物。
カイソク	気持ちがよいほど速いこと。停車駅を少なくして早く目的地に着くようにすること。
カイタイ	組み立ててある物をばらばらに分けること。
カイタク	荒地や山林などを、田畑や人の住める所にすること。
カイダク	気持ちよく承諾すること。
カイダシ	市場・問屋・産地などに出向いて品物を購入すること。
カイダン	ある問題について、公的に面と向かって話し合うこと。
カイチク	建物の全部または一部を建てかえること。リフォーム。
カイチユウ	ふところやポケットの中。「○○○○○時計」「○○○○○電灯」
カイチヨウ	会社で、社長の上に置かれる最高位の役職。会を代表する人。
カイツウ	鉄道・道路・電話などの施設が完成して通じるようになること。
カイヅカ	古代の人が食べた後の殻が積もってできた遺跡。
カイテ	購入する側。
カイテイ	海の底。
カイテン	くるくる回ること。
カイトウ	問題を解いて答えを出すこと。または、その答え。
カイドウ	大きな町と町を結び、中央から地方へと通じる主要な道路。
カイドク	古文書や暗号などを読み解くこと。
カイヌシ	その動物を飼っている人。
カイネ	物を購入するときの値段。物を仕入れるときの値段。
カイハツ	考えたり、工夫して新しい物を作り出すこと。
カイバシラ	二枚貝の内部にあって、からを開閉する働きがある筋肉。
カイヒヨウ	投票箱を開いて、投票の結果を集計すること。
カイフウ	手紙などの封を開くこと。
カイフク	元通りの状態に戻ること。
カイブツ	正体のわからないあやしいもの。化け物。
カイブン	逆から読んでも同じになる文句。シンブンシ。トマト。
カイヘイ	開いたり閉じたりすること。
カイホウ	戸や窓を開け放すこと。
カイボウ	病気や仕組みを調べたりするために、生物の体を切り開くこと。
カイム	まったくないこと。
カイメイ	解き明かすこと。
カイモノ	品物を買うこと。または、買った物。
カイヤク	契約や約束を取り消すこと。
カイヨウ	広く大きな海。大陸の対義語。
カイラン	文書・本などを順に回して読むこと。
カイリキ	並外れて強い力。
カイリユウ	海水の大きな流れ。
カイリヨウ	悪いところや欠点を直して、より良くすること。
カイロ	身体を温める物。「使い捨て○○○」
カイワ	相手と向かい合って話をすること。
カウボーイ	牧場に雇われて、家畜の世話をする男。
カウンター	客と従業員を仕切るテーブル。数を数えること。
カウント	英語で数を数えること。
カエウタ	ある歌の旋律に別の歌詞を当てはめた歌。
カエダマ	本人のように見せかけて別の人を使うこと。また、その人。
カエデ	もみじの別の呼び名。
カエバ	取り替えて使う刃。
カエリ	元の場所に戻ること。
カエリザキ	春咲いた花が秋になって再び咲くこと。
カエル	水辺にすむ両生類。後ろ足でよくはねる。子はおたまじゃくし。
カエン	燃え上がるほのお。
カオ	首から上の前の部分。目・鼻・口が付いている所。
カオイロ	顔面の表情。機嫌。
カオナジミ	知り合い。よく会った人。
カオモジ	電子メールなどに用いる、記号や字で表現した表情。
カオリ	いいにおい。
カカオ	ココア・チョコレートの原料。
カカク	商品の値段。
カカシ	作物を鳥などに荒らされないように田畑に立てておく人形。
カカリ	何かの仕事を受け持った人。
カカワリ	関係。つながり。
カガク	いろいろな事がらを研究し、その中から決まりを見つけて人間の生活に役立てようとする学問。
カガミ	自分の顔や姿を映す道具。人の模範、手本。
カガヤキ	きらめき、かがやくこと。または、その光。
カキ	岩などに付く食用の二枚貝。オイスター。
カキカタ	字を書く方法。筆の運び方や、その順序。
カキテ	書く人。書いた人。
カキネ	敷地を区切るための仕切りや囲い。
カギ	錠（じょう）を開けたり閉めたりするための短い棒状の金具。
カギアナ	キーを差し込む場所。
カギリ	限界。その範囲のすべて。
カクサゲ	資格・地位・等級などを低くすること。
カクシアジ	料理の味を引き立てるために、別の調味料を少し加えること。
カクシキ	特別に決まっている、しきたりや礼儀作法。
カクシゲイ	宴会などで余興として披露する素人芸。
カクシン	固く信じること。信じて疑わないこと。
カクジツ	間違いなく、確かであるさま。
カクスウ	漢字を組み立てている点や線の数。
カクセイキ	音や声を大きくして遠くまで聞こえさせる器械。
カクダイ	大きくする。広くする。
カクチ	あちらこちらの地方。
カクチヨウ	広げて大きくすること。
カクテイ	はっきり決まること。きちんと決まること。
カクテル	数種の洋酒に果汁・シロップ・香料などを混ぜ合わせた飲み物。
カクトク	苦心・努力の結果として、自分のものにすること。
カクド	角の開きの大きさ。
カクニン	はっきりと確かめること。
カクハン	かき混ぜること。
カクホ	しっかりと手に入れること。しっかりとつかまえること。
カクヤス	普通よりも安いさま。
カクリツ	しっかりと打ち立てること。しっかりとしてぐらつかないこと。
カクレガ	人に知られないようにこっそり隠れ住んでいる家。
カグ	タンスや机、いすなど、室内で使用する大きな道具。
カケ	お金や品物を出し合って、勝った方がそれをとるという決まりでする勝負。ばくち。
カケアシ	速く走ること。
カケイ	先祖から伝わって受け継がれた、その家の血筋。「○○○図」
カケオチ	結婚を許されない相愛の二人が、ひそかによその土地に逃げ隠れること。
カケコミ	走って中に入ること。時期やチャンスをのがさないように急ぐこと。
カケゴエ	芝居や試合などで人に向かって掛ける声。何かを始めるときの呼びかけ。
カケザン	足し算の繰り返しの結果となる数を求める計算。
カケジク	床の間などに掛けて鑑賞できるようにした書画。
カケソバ	ゆでたソバをどんぶりに入れ、熱い汁をかけたもの。
カケツ	提出された議案をよいと認めて決定すること。
カケツコ	走って速さを競う遊び。
カケドケイ	柱や壁に取り付ける時計。
カケヒキ	話し合いをしながら相手の出方を見て、自分の利益をはかること。交渉。
カケブトン	寝るときに体の上に掛ける。
カケラ	物の欠けてはなれた小さな部分。
カゲ	光をさえぎって、黒く映し出される物の形。水などの面に映し出される姿。
カゲエ	灯火によっていろいろな形を壁や障子に映し出す遊び。
カゲボシ	日光に直接当たらない、風通しのよい場所で乾かすこと。
カゲムシヤ	敵をあざむくために大将などに扮装させて、身代わりになる武士。
カゲン	加えたり減らしたりして、調節すること。
カコ	過ぎ去った時間。昔。
カコウ	原料や元になる物に手を加えて新しい物を作ること。
カコミ	周りを取り巻く物。
カゴ	物を入れるもの。「買い物○○」
カサ	雨や日光をよけるために使う道具。
カサン	付け加えること。足し算をすること。
カザグルマ	風を受けると回るように、紙などで作ったおもちゃ。
カザムキ	風の向き。
カザリ	美しくするために、物を下げたり、置いたりすること。または、その物。
カザン	地下のマグマがガスといっしょにふき出してできた山。
カザンバイ	地中のマグマから噴出した、直径2mm以下の細かい物。
カシ	お茶うけやおやつなどにする間食用の食べ物。あめ玉、まんじゅう、ケーキなど。
カシキリ	一定期間、特定の個人や団体だけが独占的に利用できるようにすること。
カシダシ	公共機関などが物を貸して外部に持ち出させること。
カシパン	餡やクリーム、ジャムなどを付けておやつに。
カシユ	歌うことを職業にしている人。シンガー。
カシヨ	その部分。
カシラモジ	最初の文字。イニシャル。
カジ	掃除、洗濯、炊事などの、家庭生活のための雑事。
カジツ	植物の実。
カジユウ	果物をしぼった汁。
カスタード	牛乳・鶏卵・砂糖をよく混ぜ合わせ、香料を加えて煮つめた菓子の原料。
カステラ	卵、砂糖、小麦粉を混ぜて、スポンジのようにむし焼きにした洋菓子。
カスミ	うすい霧。もや。
カズ	一、二、三、一つ、二つ、三つなど。物の多い、少ないを表す。
カズノコ	にしんの卵を調理した食べ物。
カセイ	太陽系の惑星の一つ。直径は地球の約二分の一で、地球のすぐ外側を回る。
カセキ	むかし地球上にすんでいた生物が、地中にうまり、石のようにかたくなって残ったもの。
カセギ	生活のために働くこと。働いて得る収入。
カセツ	仮に立てた考え方によって説明すること。
カゼ	空気の動き、空気の流れ。くしゃみ、鼻水、鼻づまり。
カゼイ	国にお金を払うこと。払うように強いること。
カゼグスリ	くしゃみ、鼻水、鼻づまり、頭痛などを治すための薬。
カゼトオシ	空気の通り道。
カソ	人口が非常に少ないこと。
カソク	しだいに速度を加えること。
カゾク	同じ家で暮らしている親子・兄弟など。
カタ	首の付け根から腕の付け根にかけての、体の部分。
カタカナ	外来語に由来する言葉によく使われる表音文字。
カタガキ	社会的な地位・身分・役職など。
カタガミ	同じ形を写し取るための、特定の形状をした紙。
カタガワ	一方の側面。
カタガワリ	人の負債などを別の人が代わって引き受けること。
カタク	家。住居。「○○○捜索」
カタクリコ	白いデンプンの粉。調理用・和菓子の材料として使われる。
カタグルマ	人を首をまたぐようなかっこうで乗せること。
カタコト	言葉の一部分。不完全でたどたどしい言葉。
カタコリ	首筋の筋肉がこわばり、疲れや不快感を伴う症状。
カタスミ	中央から離れた目立たないところ。
カタタタキ	やんわりと退職などを勧告すること。
カタチ	目で見える物のかっこう。外から見える様子。
カタツムリ	マイマイ類に属する、陸生の巻貝の総称。デンデンムシともいう。
カタテ	両手ではなく……。
カタナ	江戸時代、武士が腰に差した刃物。
カタハバ	スーツ選びで計測する長さの一つ。
カタホウ	対になっているものの一つ。
カタマリ	まとまったもの。ある程度の大きさを持つもの。「肉の○○○○」
カタミチ	行きか帰りかの、どちらか一方。
カタヤブリ	世間の常識や習慣の枠から大きくはずれていること。
カダイ	達成するために取り組まなければならないこと。
カダン	柵などで囲って草花を植えている場所。
カチ	値打ち。品物の良し悪し。
カチカン	物事の善悪・優劣を見極める基準となる個人の判断方法。
カチク	生活に役立てたり、かわいがるために飼う動物。
カチマケ	勝負。
カチヨウ	官庁・会社などで、係より大きく部よりも小さい区分を管理する役職。
カツカザン	現在噴火活動をしている山。
カツキ	生き生きとして調子がいい様子。
カツコ	「」（）〔〕などの記号。
カツコウ	姿。形。状態。様子。
カツコク	それぞれの国。
カツサイ	声を上げて盛んにほめること。「○○○○を浴びる」
カツジ	新聞・本・雑誌などの印刷物。
カツセイカ	反応や働きが盛んになること。
カツター	物を切断する道具や機械。
カツト	英語で切断すること。
カツドウ	生き生きと元気よく働くこと。
カツパ	想像上の動物。頭の上に皿がある。
カツパツ	生き生きとして元気のいいさま。
カツプル	夫婦・恋人同士などの一組。
カツヤク	目覚ましく貢献すること。
カツヨウ	そのものの働きをうまく役立てて使うこと。
カツラ	かみの毛に似せて、頭に付ける物。
カテ	生きていくための食べ物。食料。
カテイ	夫婦・親子などが生活を共にする集団。
カデン	テレビ・洗濯機・冷蔵庫など。「白物○○○」
カド	物のはしのとがった所。
カドデ	自分の家から出発し、新しい生活を始めること。
カドマツ	正月に家の門口に立てる飾り物。
カナ	漢字を元にして日本で考え出された音節文字。
カナアミ	ワイヤーメッシュ。
カナイ	他人に対して自分の妻を言う言葉。家の中。「○○○安全」
カナグ	金属製の付属品。
カナダ	北アメリカ大陸の北部にある、世界で二番目に広い国。首都はオタワ。
カニ	かたいからに包まれ、一対のはさみとたくさんの足をもつ動物。
カニユウ	団体などに仲間入りすること。
カヌー	こいで進む原始的な小舟。
カネ	物の売り買いに使われる物。
カネツ	温めて温度を高めること。
カネヅカイ	金銭の扱い。「○○○○○が荒い」
カネモウケ	金銭の利益を得ること。
カネモチ	富裕層。
カノウ	やろうと思えばできること。実現できること。
カノウセイ	現実となりうる見込み。実現できるという見込み。
カノジヨ	話題の女の人。女友達。
カハンスウ	総数の半分より多い数。
カバ	アフリカの川や湖にすむ、草食の動物。口が大きく胴が太い。
カバン	中に物を入れて持ち運ぶ用品。皮や布でできている。
カバー	傷やよごれを防ぐために物をおおう物。
カビン	花を生けるための入れ物。
カフエ	コーヒー。喫茶店。
カブ	根が太くて丸みがかかった根菜類の植物。
カブカ	証券取引所で売買される銘柄の価格。
カブキ	劇・音楽・舞踊などの要素を集大成した日本特有の総合演劇。
カブト	合戦のとき頭部を保護するためにかぶった鉄製または皮製の武具。
カブトムシ	昆虫の一種。体は黒色でつやがある。オスには大きな角がある。
カブヌシ	これになると配当金がもらえるかも。
カヘイ	お金のこと。
カヘン	変えることができること。
カベ	建物の外側の囲いや、部屋と部屋の仕切り。障害物。
カベガミ	装飾や補強のために室内に貼る紙。コンピュータの画面の背景となる画像。
カホウ	家の宝。
カボチヤ	秋に大きな黄色の実をつける、うりの仲間の野菜。
カマ	米をたいたり、湯をわかしたりする金属製の道具。
カマキリ	体が細長く、特徴的な前足のある昆虫の一種。
カマド	なべなどを乗せ、下から火を燃やして煮炊きをするための設備。
カマボコ	魚の肉をすりつぶし、味をつけてむしたり焼いたりした食べ物。
カミ	鉛筆やペンで文字を書けるよ。
カミアワセ	上下の歯がぴたりと合うこと。またはその具合。
カミガタ	ヘアスタイル。
カミサマ	神の敬称。
カミシバイ	次々と絵を見せながら物語る見世物。
カミソリ	毛をそる刃物。するどいもののたとえ。
カミツ	限られた地域・範囲・時間の中に集中すること。「○○○なスケジュール」
カミナリ	雲の中にたまった電気が空中に放電する現象。
カミノケ	頭部に生える。
カミフブキ	祝賀や歓迎などのために、細かく切ってまき散らすもの。
カミブクロ	紙で作った袋。
カミワザ	きわめて超人的な技術。
カメ	は虫類の一種。体は固い甲羅で覆われる。
カメラ	英語で写真機のこと。
カメン	顔をかくすためにかぶるお面。
カモ	鳥の一種。だましやすい相手のこと。
カモク	口数が少ないこと。
カモツ	大きな荷物。
カモメ	海鳥の一種。体は全体的に白いが、背中と翼は灰色。
カヤ	蚊を防ぐために、つり下げてまわりをおおう、目の細かい網。
カヤク	熱やショックによって、急に爆発する薬品。
カユ	多めの水で、米を柔らかく炊いたもの。赤ちゃんや病人の食べ物。
カヨウ	節をつけてうたう歌の総称。
カヨウビ	月曜日の次の日。
カラ	入れ物に何も入っていないこと。
カラアゲ	肉に味を付けて油であげた物。
カラオケ	歌の伴奏だけを再生する装置。また、それに合わせて歌うこと。
カラクチ	刺激的な風味。食べると熱くなるかも。
カラクリ	道具や人形を動かす仕組み。仕掛け。
カラシ	香辛料の一種。黄色でからい。
カラダ	頭・胴・手・足などの全体を言う言葉。
カラツト	宝石の重さを表す単位。200ミリグラム。
カラツポ	中に何も入っていないこと。
カラテ	素手や素足で、ついたりけったりして相手と争う武道の一種。
カラブリ	振ったバットにボールが当たらないこと。
カラマワリ	機械や車などが、むだな回転をすること。
カラー	英語で「色」「色彩」のこと。
カリ	鳥やけものなどを野山へとりに行くこと。
カリヨク	火が燃えるときに出す熱の力。
カルイシ	溶岩が急速に冷えてできた、軽い岩石。浮き石。
カルシウム	白くやわらかい金属で、動物の骨に含まれている元素。
カルテ	医師が患者の体の様子を記録するためのカード。
カルト	熱狂的な信者を持つ新興の宗教集団。
カルビ	牛・豚のばら肉。
カルワザ	つな渡り、はしご乗り、玉乗りなど。曲芸。
カレ	話し手および相手以外の話題の男の人を指す。
カレキ	「○○○に花を咲かせましょう」
カレクサ	牧畜の植物性のエサ。
カレツジ	英語で大学のこと。
カレラ	あの人たち。
カレンダー	英語で暦（こよみ）のこと。
カレー	黄褐色をした粉末の混合香辛料。「○○○ライス」
カロリー	食べ物が消化されるとき、体内で生じる熱量の単位。
カワ	生物の表面をおおっているもの。中身を包んでいるもの。
カワアソビ	この時はライフジャケットを。
カワカミ	水の流れの上流。
カワシモ	水の流れの下流。
カワラ	粘土を固めて焼いた物。屋根をふく材料となる。
カワリ	あるものが他のものと交代すること。
カン	金属製の容器。
カンエン	「静かな臓器」が炎症を起こす病気。
カンカク	外から受けるしげきを感じるはたらき。または、その感じ。
カンガエ	心の中で思っていること。思っている内容。
カンガツキ	吹き口から管に息を吹き込み、中の空気を振動させて音を出す楽器。吹奏楽器。
カンガルー	オーストラリアにすむ動物。後ろ足と太い尾でよくはねる。
カンキ	空気を入れ替えること。
カンキヤク	芝居や野球などを見ている客。
カンキヨウ	人間や生物を取り囲んでいる、周りの状態。
カンキリ	金属製の詰め物のフタを開ける金属製の道具。
カンケイ	関わり。関わり合い。
カンケツ	簡単で、はっきりしているさま。
カンゲイ	心から迎えること。喜んで迎えること。
カンゲキ	感心して心がふるい立つこと。
カンコウ	よその土地の風景や文化などを見物すること。
カンゴ	けが人や病人の世話をすること。
カンゴシ	医師の補助や、けが人・病人の看護を職業とする人。
カンサイ	京都・大阪・神戸を中心とする一帯。
カンサツ	物事の様子をありのまま、注意してくわしく見ること。
カンザシ	女性の髪にさす装飾品。
カンシ	見張ること。見守ること。
カンシヤ	他人の行為をありがたいと感じること。そのお礼の言葉。
カンシユウ	世の中のならわしやしきたり。
カンシヨ	サツマイモの別称。
カンシヨク	さわった感じ。手ざわり。はだざわり。
カンシン	立派な行いなどについて、ほめるべきだと思う心。
カンジ	中国から伝わってきた文字で、一字一字が意味を持っている。
カンジユク	果実や種子がうれること。
カンジヨウ	喜び・いかり・悲しみ・楽しさなどを感じる気持ち。
カンジン	大事なさま。欠くことができない大切なこと。肝要。大事。
カンスウジ	一、二、三、四、五、……。
カンセイ	全部出来上がること。
カンセツ	骨と骨のつなぎ目。体の節々。
カンゼイ	国境をこえて出入りする品物にかける税金。
カンゼン	全く欠点や不足がないこと。「○○○○無欠」
カンソウ	自分の心に思ったこと、感じたことや考えたこと。
カンソク	天体や気象などの様子や変化などをくわしく調べること。
カンタイ	二隻以上の軍艦で編成した海軍の部隊。
カンタク	浅海・湖沼などの水をほして陸地にすること。
カンタン	手軽なさま。物事がこみ入っていないさま。
カンダイ	度量が大きく、思いやりがあること。
カンダン	寒さと暖かさ。
カンチ	病気やけがが完全に治ること。
カンチガイ	間違って思い込むこと。
カンツウ	つきぬけること。
カンヅメ	食べ物の長期保存のために金属製の容器につめて加熱・殺菌した物。
カンテイ	本物かにせ物か、いい物か悪い物かを見定めること。
カンテン	見たり考えたりする立場。見方。
カンデンチ	電解液を金属製の容器に密封した、小型のバッテリー。
カントウ	東京都と、神奈川・千葉・埼玉・栃木・茨城・群馬の各県を含む地域。
カントク	映画・舞台・競技などでチームの上に立って指揮・指導する役。
カンド	受信機・測定器などが受けた刺激とそれに対する反応のほど。
カンドウ	心に深くひびいて、気持ちが動かされること。
カンナ	材木の表面を平らにけずるための大工道具。
カンニング	学生が試験のとき、不正なことをすること。
カンバン	店の名前や商品、絵などを目立つように大きくかかげた物。
カンパイ	酒を飲み交わすこと。
カンビヨウ	病人の世話をすること。
カンブ	会社や団体の中心になる人。
カンブン	中国の文字だけで書かれた文章。
カンペキ	傷や欠点が一つもないさま。
カンボジア	米の生産量が多い、インドシナ半島にある国。
カンポウ	中国から伝来した医術。
カンミン	官庁と民間。公務員と民間人。
カンムリ	身分の高い人が頭にかぶるかざり物。
カンモン	目的を達成するために、乗り越えるべき障壁。
カンヨ	仕事などに携わること。事件などに関わりを持つこと。
カンリ	任されたものがうまくはたらいたり、安全に保管されるように気を配ること。
カンリユウ	周囲よりも水温の低い流れ。
カンリヨウ	物事が完全に終わること。
カンレイ	決まって行われる事がら。しきたり。ならわし。
カンレン	物と物のつながり。「○○○○資料」
カンロク	身に備わった威厳や風格。
カンワ	中国の文字と日本語の関係を調べるのは「○○○辞典」
カーテン	部屋を仕切ったり、窓などにかけたりする布。
カート	荷物の運搬に用いる小型の手押し車。
カード	四角い小さな厚い紙。トランプ。
カーナビ	人工衛星の電波を利用し、自動車の現在位置や進行方向などを表示する装置。
カーブ	曲がっていること。曲げること。
ガイケン	外から見た様子。
ガイコウ	他の国との交わりや付き合い。
ガイコク	よその国。自分の国以外の国。
ガイシ	国内の事業に投資される外国の資本。
ガイシヤ	外国製の自動車。
ガイシユツ	外へ出かけること。
ガイジン	他の国の人。
ガイチユウ	会社・工場などが、仕事の一部を外部の業者に発注すること。
ガイテキ	外部または外国から攻めてくる敵。
ガイトウ	街の通りを明るくするための電灯。
ガイド	案内。手引き。案内人。「○○○ブック」
ガイブ	外側。仲間以外。
ガイヘキ	外側の壁。
ガイヨウ	かいつまんでまとめた要点。
ガイライ	外側から来ること。通院して診療を受けること。
ガイライゴ	外国語から取り入れられて、自国語のように使われる言葉。
ガカ	絵をかくことを職業とする人。絵かき。
ガクシキ	学問から得た豊かな知識。
ガクシヤ	学問の研究を仕事としている人のこと。
ガクシユウ	自分の知らないこと、新しいことを学び取ること。勉強。
ガクジユツ	学問や、その学問を実際に使う技術。
ガクセイ	学校で教育を受けている人。
ガクネン	学校で決めている一年ずつの区切り。
ガクフ	楽曲を五線譜などに書き表したもの。スコア。
ガクブ	大学で専攻する分野によって分けたそれぞれの部。
ガクブチ	絵画・写真・賞状などを入れて掲げるための枠。
ガクモン	学習や研究をして、知識や考え方を身に付けること。
ガクヤ	出演者が準備をしたり、休んだりする部屋。
ガクラン	詰め襟の学生服。
ガクリヨク	学習によって得られた能力。
ガクレキ	学業に関する経歴。
ガクワリ	学生に限って料金を値引くこと。。
ガケ	山や岸などが険しく切り立っている場所。
ガケツプチ	限界ぎりぎりにある状況・状態。
ガサイ	絵を描く才能。
ガザイ	絵を描くために使う材料。絵の具、筆、画布など。
ガシツ	写真・テレビなどの画像の質。
ガシユウ	絵画を集めて本にしたもの。
ガス	英語で気体のこと。
ガソリン	石油の原油を熱したときにとれる、非常に燃えやすい油。
ガゾウ	テレビなどにうつる映像。絵にかいた肖像。
ガダイ	絵のタイトル。絵のテーマ。
ガツカイ	学術研究の促進、学者同士の連絡などを目的に組織された団体や会合。
ガツキ	音楽を演奏するときに使う、音を出す道具。
ガツキユウ	生徒を一定の人数に分けた組。クラス。
ガツコウ	児童・生徒が勉強するための公共施設。
ガツシヨウ	大勢がいっしょに歌うこと。
ガニマタ	両脚がひざのところで外向きに曲がっていること。Ｏ脚。
ガハク	すぐれた画家。画家の敬称。
ガビヨウ	絵などをカベや掲示板に留めるピン。
ガフウ	絵画にあらわれた画家や流派の特色。
ガホウ	絵画を描く技法。
ガム	チューイン○○の略。
ガメン	テレビやパソコンなどに映像が映し出される場所。
ガヨウシ	絵を描くのに使う、やや厚めの白い紙。
ガラ	模様。体の大きさ。性質や感じ。ふさわしい立場や性質。
ガラス	石英・ソーダなどを高温で熱して作る、透明で壊れやすい物質。
ガリベン	学校の成績を上げるために、ひたすら勉強すること。
ガレージ	自動車の車庫。
ガンキユウ	目玉。
ガンサク	美術品などの偽物。
ガンジツ	一年の最初の日。一月一日。
ガンセキ	大きな石のかたまり。
ガンソ	ある物事を始めた最初の人や店。
ガンタン	元日の朝。
ガンネン	年号の改まった、一番最初の年。
ガンバン	硬い岩石の層。
ガンペキ	険しく切り立った岩。
ガンボウ	強く願い望むこと。
ガンマセン	ラジウムなどから出る放射線の一種。
ガンメン	顔の表面。
ガーデン	英語で庭、庭園のこと。
ガード	英語で「守る」「防ぐ」「警備」を表す言葉。
ガーリツク	英語でニンニクのこと。
ガール	英語で少女のこと。若い女性。
キアイ	心を集中させて事に当たるときの勢い。
キアツ	地面にかかる大気の重さ。
キイロ	レモンや菜の花のような色。
キウイ	ニュージーランドが原産地の果物。黄緑色で卵形。
キオク	物事を忘れずに覚えておくこと。
キオン	大気の温度。
キカ	液体がガスになること。
キカイ	人力以外の動力を使って仕事をする大きな装置。
キカイカ	人力のかわりに機械を使うこと。
キカク	新しく何かをするために計画を立てること。
キカン	のどから肺に通じる管。
キガエ	他のものを着る。
キガネ	他人に気をつかって遠慮すること。
キガン	望みがかなうように神仏に祈り願うこと。
キキウデ	力が入りやすく、細かな動作ができる方の腕。
キキメ	効く力。効果。
キキユウ	袋に空気よりも軽い気体を入れて、空中に浮かせたり、高く上げるもの。
キキヨウ	都へ帰ること。特に東京に帰ること。
キキンゾク	値打ちの高い、めずらしい金属。
キギヨウ	儲けるためにサービス、販売、生産をする事業者。
キゲン	心の調子。気分。「○○○が良い」
キコウ	ある地域の気温や湿度、雨の量など、気象の状態。
キコウシ	高貴な家に生まれた男性。気品のある男性。
キコク	自分の国に帰ること。
キコリ	山林で木を切り出すことを仕事にしている人。
キコン	すでに結婚していること。
キゴ	俳句などで、季節を表す言葉。
キゴウ	ある意味を表すための印。
キサイ	書類・書物などに書いて載せること。
キザ	服装・言動がきどっていて、嫌みに思われること。
キザイ	機械と材料。
キザシ	ある物事が起ころうとする印。前兆、前ぶれ。
キザミ	細かく切ること。浅い切れ目を入れること。
キシ	海や川が陸と接する境目。水ぎわ。
キシベ	水と陸とのさかい目のほとり。
キシヤ	新聞や雑誌を書いたり取材したりする人。
キシユ	行進などで団体の象徴となる旗を持つ役目の人。
キシヨウ	天気、気温、気圧、風の様子など、大気中で起こるさまざまな現象。
キジ	出来事を伝えるために、新聞や雑誌に書いた文章。
キジユツ	文章にして書き記すこと。書き記したもの。
キジユン	物事を比較・判定するときの基礎になるよりどころ。
キジン	性格や言動がふつうとはひどく変わっている人。おかしな人。
キスウ	整数のうち、二で割り切れない数。１、３、５、７など。
キズアト	傷のついたあと。傷の治ったあと。
キズグスリ	傷を治すための薬。
キズナ	はなれることができない、人のつながり。
キセイ	規則を決めて制限すること。また、その規則。
キセキ	実際に起こるとは思われないような不思議な出来事。
キセツ	春夏秋冬のこと。シーズン。
キゼツ	気を失うこと。
キソ	建物や機械の土台。もとになる事がら。基本。
キソク	物事を行う場合に、守らなければならない決まり。規定。規約。
キゾク	政治的・社会的特権を世襲する上層階級。恵まれた境遇を享受している人。
キタ	太陽が出てくる方に向かって左の方角。
キタイ	空気などのように、決まった形・体積がなく、自由に流れ動くもの。ガス。
キタカゼ	北から吹いてくる風。
キタク	自分の家に帰ること。
キタグニ	北の方にある国や地域。
キチ	行動の拠点となる場所。「秘密○○」
キツエン	たばこを吸うこと。
キツカケ	何かを始める手がかり。動機。チャンス。
キツク	ボールをけること。
キツサテン	客に飲み物やケーキ、軽い食事などを売って、そこで飲み食いさせる店。
キツチン	台所。調理場。
キツツキ	森林にすむ鳥。するどいくちばしで木の幹をつついて穴を空け、虫をとって食べる。
キツテ	代金として封筒やはがきに貼るシール。「郵便○○○」
キツネ	山野にすむ、犬の仲間のけもの。口・耳がとがり、尾が太く長い。
キツプ	乗車券・入場券など、お金を払ったしるしにもらう紙切れ。
キヅカイ	あれこれと心の中で気をつかうこと。
キヅチ	木製のつち。
キテイ	物事の内容・手順・方法などを一定の形に定めること。またはその定めや決まり。
キテキ	蒸気の噴出によって音を出す仕組みの笛。またはその音。
キドウ	肺につながる空気の通路。「○○○の確保」
キナコ	いった大豆をひいて粉にしたもの。
キニユウ	書き入れること。
キヌ	蚕のまゆから作った糸や布。
キヌイト	蚕のまゆから作った糸。
キネ	穀物やもちをつくために用いる木製の道具。
キネン	あることの思い出に残しておくこと。または、その物。
キノウ	今日の一つ前の日。
キノコ	野山の木や木材などに生え、多くは、かさの形をした植物。
キハク	ひるまずに立ち向かう強い精神力。
キハツ	液体が常温で気化すること。
キバ	肉食動物の上下のあごにある、するどくてじょうぶな歯。
キバクザイ	起爆に用いる火薬。
キビダンゴ	きびの実の粉で作っただんご。
キビン	機に応じて頭や体をすばやく適切に働かせること。
キフ	公共の団体・事業や神社などに金品を差し出すこと。
キフク	土地などが高くなったり低くなったりしていること。
キフジン	高貴な身分の女性。
キブトリ	厚着をして太って見えること。着ぶくれ。
キブン	心持ち。ふんいき。
キヘン	「材」「林」「橋」などの漢字の左がわの部首。
キホン	物事のよりどころとなる大もと。
キボ	物事の仕組みや組み立ての大きさ。
キボウ	こうなりたい、こうしたいという強い願い。未来に対する明るい見通し。
キマグレ	その時の気分や思い付きで行動するさま。気持ちが変わりやすいさま。
キマジメ	融通がきかないほどまじめなこと。
キマリ	決まっていること。決めたこと。
キミ	相手の人を指す言葉。あなた。
キミガヨ	日本の国歌。
キミツ	国や団体の大切な秘密。
キミドリ	黄色がかった緑色。
キミヨウ	原因も理由もわからない不思議なさま。
キムチ	朝鮮の辛い漬物。
キメイ	名前を書き記すこと。サイン。
キメテ	物事を決めるもの。
キモチ	物事や人に対して感じる心の状態。
キモノ	日本のむかしからの服。和服。
キヤク	まぬかれた人。たずねてきた人。ゲスト。
キヤクシツ	客をもてなすための部屋。客間。
キヤクホン	映画や劇などのせりふや舞台の様子などを書いたもの。
キヤシヤ	細くて弱々しいこと。
キヤスト	映画・演劇・テレビドラマなどの配役。
キヤツシユ	英語で現金のこと。
キヤツチ	つかむこと。とらえること。
キヤツプ	かぶせるふた。
キヤビア	チョウザメの卵を塩づけにした食品。
キヤプテン	主将。船長。艦長。
キヤベツ	あぶらなの仲間で野菜の一種。
キヤンパス	大学などの構内。学園。
キヤンプ	野外でテントを張って生活すること。
キユウ	ここのつ。
キユウイン	吸い込むこと。吸い付けること。
キユウエン	こまっている人などに力をかして助けること。救助。
キユウカ	学校や仕事などの休み。
キユウカイ	野球に関係する人々の社会。
キユウカン	新聞・雑誌などの定期刊行物が発行を休むこと。
キユウガク	学生や生徒が長期間学校を休むこと。
キユウギ	ボールを使って勝敗を争う競技。
キユウクツ	せまくて、または小さくて、自由に行動できないさま。
キユウケイ	つかれた体や頭を休めること。または、その時間。
キユウコウ	特別な理由のため、学校が休みになること。
キユウコン	植物の根や地下茎が栄養分をたくわえて、丸くふくらんだもの。
キユウサイ	お金や物がなくてこまっている人を救い、助けること。
キユウシキ	物事の物の仕組みや考えなどが、古いこと。
キユウシヨ	体の中で生命にかかわる大事な部分。
キユウジ	野球をする青少年。
キユウジツ	休むことに決まっている日。
キユウジヨ	救い、助けること。
キユウジン	その職場で働いてくれる人をさがし求めること。
キユウス	お茶を入れるときに使う、小型で注ぎ口と取っ手の付いた茶器。
キユウスイ	飲み水などの水を家庭や工場などに送ること。
キユウセイ	結婚・養子縁組などで改姓する前の以前の姓。
キユウセン	交戦国が合意の上で戦闘行為を一時中止すること。
キユウソク	物事の進み方が非常に速いこと。たちまち。すみやか。
キユウゾウ	急に増えること。
キユウタイ	球状の物体。
キユウチ	追いつめられて、どうすることもできない、非常に苦しい立場。
キユウテイ	皇帝・国王の住んでいるところ。
キユウテン	物事の状態や様子が急に変わること。
キユウデン	皇帝・国王などが居住する御殿。
キユウトウ	湯を供給すること。
キユウバン	タコやイカの足に付いていて他のものに吸い付く器官。
キユウヘン	状態が急に変わること。
キユウボ	急いで募集すること。
キユウム	急いでしなくてはならない仕事や任務。
キユウメイ	危険にさらされている人命を救うこと。
キユウメン	球の表面。
キユウユ	油を補給すること。
キユウヨ	やとい主から仕事の報酬として、働いた人に支払われるお金。
キユウヨウ	急ぎの用事。
キユウリ	うりの仲間の緑色の細長い野菜。
キヨウ	本日。この日。
キヨウイク	人間の才能をのばし、知識や技術をあたえ、りっぱに育てること。
キヨウウン	運が強いこと。強い運勢。
キヨウエイ	泳ぐ速さを競うこと。
キヨウエン	主役格の俳優や歌手が二人以上いっしょに出演すること。
キヨウカ	さらに強くすること。
キヨウカイ	土地や物事のさかい目。
キヨウカン	他人の意見や感情をまったくその通りだと感じること。またはその気持ち。
キヨウガク	非常に驚くこと。
キヨウギ	スポーツなどでたがいの技を競うこと。
キヨウクン	教えさとすこと。反省点。
キヨウグウ	その人が置かれている立場。めぐり合わせ。
キヨウコ	強くて固くしっかりしていること。
キヨウサク	農作物のできがきわめて悪いこと。
キヨウザイ	学習をするときに使う教科書や、教育用材料のこと。
キヨウシ	学校で一定の資格をもって児童・生徒・学生などの教育にあたる人。教員。
キヨウシツ	学校で生徒が学習を行うための部屋。
キヨウジユ	学問・技術・技能などを教えること。大学などで専門の学問・技能を教え、またその研究に従事する職。
キヨウジン	しなやかで強いこと。
キヨウセイ	力づくでむりにさせること。
キヨウソウ	たがいに勝ち負けや良し悪しを争うこと。
キヨウゾウ	人物の胸から上の彫像・塑像。
キヨウゾン	複数の異なったものが同じ環境のもとで同時に存在すること。
キヨウダ	強く打つこと。
キヨウダイ	兄と弟。
キヨウチヨ	二人以上の人が共同で一つの本を書き著すこと。
キヨウツウ	ある事がらが、二つ以上のもののどれにも当てはまること。
キヨウテイ	モーターボートによる競走。またそれをかけごとの対象とする賭博。ボートレース。
キヨウテキ	強い敵。
キヨウド	物の強さの度合い。
キヨウドウ	二人以上の人が力を合わせて同じ仕事をすること。
キヨウバイ	複数の買い手に値を付けさせ、最も高い価格をつけた人に売ること。オークション。
キヨウブ	胸の部分。
キヨウミ	ある物事をおもしろいと思う心。
キヨウメイ	振動体が他の振動体の作用を受けて固有の振動数で振動すること。
キヨウユ	小中高校、幼稚園、看護学校などの正教員。
キヨウユウ	一つの物を二人以上の人が共同で持つこと。シェア。
キヨウヨウ	学問や知識を身に付けることによって養われる、豊かなものの考え方。
キヨウレツ	はげしく強いさま。
キヨカ	何かをしてもいいと許すこと。
キヨカン	体が非常に大きい男性。大男。
キヨガク	金額がきわめて多いこと。
キヨクゲイ	ふつうの人にはできない危険で変わった芸当。かるわざ。
キヨクセン	なめらかに曲がった線。
キヨクド	程度がはなはだしいこと。
キヨクメン	平面でない曲がった面。
キヨシキ	結婚式などをとり行うこと。
キヨシユ	意思表示のために、手を挙げること。
キヨジユウ	ある決まった建物・土地などに住むこと。
キヨジン	体が非常に大きい人。
キヨタイ	なみ外れて大きな体。
キヨテン	ある活動をする足場となる地点。
キヨネン	今年の前の年。
キヨヘイ	兵を集めて軍事行動を起こすこと。
キヨボク	大きな木。巨樹。
キヨヨウ	たてまえや原則から外れているが、この程度までならいいとして許すこと。
キヨリ	ある地点から、ある地点までの長さ。
キラク	気づかいや気苦労がなく、のんびりしていること。のんきなこと。
キリ	大気中の水蒸気が集まって小さな水滴となり、煙のように立ち込めるもの。
キリエ	紙を人や動物などの形に切り抜いて台紙にはった物。
キリカエ	切り替えること。転換すること。
キリカブ	木を切り取った後に残る、根の付いている幹。
キリキズ	刃物などで切った傷。
キリツ	すわっていた者が立つこと。
キリフキ	液体を霧状にして吹きかけるための器具。スプレー。
キリミ	魚肉を適当な大きさに切ったもの。
キリユウ	大気中の空気の流れ。
キリヨク	物事をやりぬこうとする強い精神力。
キリン	アフリカの草原にすむ、首がとても長い動物。
キレアジ	切れ具合。
キロ	単位の前に付いて千倍を表す言葉。
キロク	後で伝えたい事がらを、文字や録音、映画などにして残しておくこと。
キログラム	千グラム。
キン	値打ちのある金属で、非常に重く、黄色いつやを持つもの。
キンイツ	価格・量・品質などがどれも一様であること。
キンウン	金銭に関する運勢。
キンエン	たばこを吸うことを禁ずること。
キンカ	金を主成分とする貨幣。
キンカイ	陸地に近い海。
キンガク	お金の量。
キンガン	遠くの物がはっきり見えない目。近視。
キンキユウ	事がらがさしせまっていて、急いでしなければならないさま。
キンギヨ	観賞用の小型の魚。フナの仲間。
キング	英語で「王」のこと。
キンコ	現金や大切な書類などを入れておく、鉄などでできた、がんじょうな入れ物。
キンザン	金を産出する鉱山。
キンシ	ある行いをしてはいけないと止めること。
キンシツ	ある物質のどの部分をとっても物理的・化学的に同じ性質を持っていること。
キンジツ	近い将来。近いうち。
キンジヨ	近い所。
キンセイ	地球のすぐ内側を回る、太陽系の惑星。
キンセン	お金。
キンゾク	金・銀・鉄などの鉱物。
キンダイ	現代に近い時代。
キンダイカ	近代的な状態に移行すること。
キンチヨウ	心が引きしまること。争いが起きそうな様子。
キントウ	どれにも差がなく等しいさま。
キンニク	細い筋が集まって、体を動かすはたらきがある部分。
キンネン	最近の数年。ここ数年。
キンバ	金冠をかぶせた歯。金製の入れ歯。
キンパク	金を紙のように薄く延ばしたもの。
キンパツ	金色のかみの毛。ブロンド。
キンピカ	金色にぴかぴか光り輝くこと。
キンピン	金銭と品物。
キンベン	仕事や勉強を精を出すさま。
キンミツ	物事と物事がしっかり結びついていること。
キンミヤク	金の鉱脈。資金源。金づる。
キンム	会社や役所に勤めること。
キンメダル	金、または金メッキで出来たメダル。
キンユウ	金銭の融通。資金の需要と供給に関すること。
キンヨウ	木曜の次の日。
キンリ	貸し金・預金などにつく利子。利息。利子の割合。
キンリヨク	筋肉の力。
キンルイ	きのこやかびの仲間。
キンロウ	心身を使って仕事にはげむこと。
キー	英語でカギのこと。
キーワード	理解や問題解明の手がかりとなる重要な語句。情報検索のときに使う語句。
ギイン	選挙で選ばれて、議会で話し合ったり、物事を決定したりする人。
ギカイ	選挙で選ばれた人が集まって、政治や法律などについての会議をする所。
ギシ	工業・土木建築などの専門的な技術を身に付け、それを職業にしている人。エンジニア。
ギシキ	お祝いや祭り、とむらいなどのとき、決まった形式で行う作法。
ギジユツ	うまく行うための方法、わざ。
ギジンホウ	文章を書くとき、人以外のものを人にたとえて表現する方法。
ギセキ	議場での議員の席。議員の資格。
ギター	六本のげんを張り、指やつめではじいて音を鳴らす楽器。
ギダイ	会議にかけて討議する題目。
ギチヨウ	会議の席で議事を進め、採択を行う人。議会を代表する人。
ギノウ	物事を行うときの技術上の能力。
ギフト	英語で贈り物のこと。
ギホウ	技術上の方法。
ギム	当然しなければならない務め。
ギモン	疑って問うこと。疑わしいこと。「○○○点」
ギヤク	さかさま。反対。
ギヤクサン	逆方向に計算すること。
ギヤクテン	立場がひっくり返って、反対になる。反対に回る。
ギヤクフウ	進行方向から吹いてくる風。
ギヤグ	人をわらわせるための、こっけいなしぐさやせりふ。
ギヤツプ	意見・考え方などのへだたり。
ギヤラ	出演料。契約料。
ギユウドン	牛肉をネギなどと一緒に煮て、汁とともにどんぶり飯にかけたもの。
ギユウニク	食用の牛の肉。
ギヨウカイ	同じ事業や職業をしている人々の社会。
ギヨウギ	日常生活での、礼儀にかなった動作や態度。
ギヨウシヤ	品物を作ったり、売買したりしている人。商売人。
ギヨウシユ	事業の種類。業務の種類。
ギヨウジ	いつも決まった日程で行われるもよおし。
ギヨウセイ	憲法や法律にしたがって、国や県や市町村を治めること。
ギヨウセキ	仕事や研究のすぐれた成果。
ギヨウテン	非常におどろいて天をあおぐこと。
ギヨウム	職業・事業として日常継続して行われる仕事。「○○○○連絡」
ギヨウレツ	大勢がならんで列を作っていること。またはその列。
ギヨギヨウ	魚介類・海藻などの捕獲・採取・養殖などを行う産業。
ギヨグン	水中にいる魚の群れ。「○○○○探知機」
ギヨジヨウ	大量の魚が取れる場所。
ギヨセン	魚・貝・海草などを取るための船。
ギヨニク	魚の肉。
ギヨライ	水中を走り、目的物に命中すると爆発する爆弾。
ギヨルイ	魚の仲間。
ギヨーザ	中国料理の一つ。小麦粉を練って薄く延ばした皮でひき肉などを包み、調理した食べ物。
ギリ	人と付き合う上でしなければならないこと。
ギリシヤ	ヨーロッパ南東部の国。地中海に面し、暖かい。首都はアテネ。
ギロン	たがいに考えを出して話し合うこと。
ギン	金より少し軽く、白色の美しいつやを持った金属。
ギンカ	銀を主成分とする貨幣。
ギンガ	あまの川。星が集まったように見える場所。
ギンコウ	お金をあずかったり、他にお金を貸し出したりする機関。
ギンザ	東京の中央区にある、にぎやかな商店街。
ギンザン	銀を産出する鉱山。
ギンナン	いちょうの種子。
クイ	地中に打ち込んで目印や支柱にする棒。
クイキ	区切られた範囲の地域。
クイズ	問題を出してそれに答えさせる遊び。またはその問題。
クイチガイ	かみ合わないこと。ずれること。
クイニゲ	飲食した代金を払わないで逃げること。
クイーン	英語で女王のこと。
クウカン	何もない空いている場所、広がり。スペース。
クウキ	地球をつつんでいる、無色・無臭の気体。
クウグン	航空機による攻撃や防御を主な任務とする軍隊。
クウコウ	飛行機が出発したり、着いたりする所。
クウセキ	空いている席。
クウソウ	実際にはありえないことを、頭の中で思いうかべ、想像すること。
クウチユウ	地面より上。空の中。
クウハク	何も書いていない部分。余白。
クウフク	おなかがすくこと。
クガツ	一年のうち、九番目の月。
クキ	植物の花や葉を支える部分。
クギ	金属・竹・木などの一方のはしをとがらせて、物を打ち付けるときに使う物。
クギヅケ	くぎを打って動かないようにくっつけること。
クギリ	物事の一つの切れ目。
クク	一けた同士の掛け算の一覧表や暗記の仕方。
クサ	くきがやわらかく、木にならない植物。
クサキ	草と木。植物。
クサバナ	草と、草にさいている花。
クサムラ	草がたくさんしげっている所。
クサモチ	よもぎの葉を混ぜて作った、うすい緑色のもち。
クサリ	金属で輪を作り、長くつないだ物。
クシ	かみをすいたり、かみ飾りにしたりするもの。
クシザシ	物をくしに刺すこと。またはくしに刺した物。
クシヤミ	鼻の中がしげきされて、急に息をふき出す体の運動。
クジ	文字などが書かれた同じ形の紙片・木片などの一つを抜き取ることで勝敗・当落・吉凶などを決めるもの。
クジビキ	くじを引くこと。くじを引いて物事を決めること。
クジヤク	キジ科の大型の鳥。雄の尾羽には青緑色の美しいはん点がある。
クジラ	海にすむ、体がものすごく大きい、ほ乳類。形は魚に似ている。
クスリ	病気やけがを治すために、飲んだりぬったりするもの。何かの効き目があるもの
クスリユビ	親指から数えて四本目の指。
クズテツ	鉄製品を作るときに出る鉄の切りくず。鉄製品をぺちゃんこにつぶしたもの。スクラップ。
クセ	無意識の習慣になっている動作や言葉。
クダ	中が空になっている細長い円筒。パイプ。チューブ。
クダモノ	木や草の実で食べられる物。
クチ	動物が食べたり、声を出したりするところ。
クチカズ	ものを言う回数。言葉数。
クチク	追い払うこと。
クチグセ	いつもくせのように言う言葉。決まり文句。
クチドメ	他人に伝えてはいけないと、止めること。
クチバシ	鳥類などのかたい口先。
クチヒゲ	鼻の下にはやしたひげ。
クチビル	口の上と下を囲む器官。
クチブエ	くちびるを円くし、息をふき出して鳴らす笛のような音。
クチヘン	「味」「呼」「吸」などの漢字の左側の部首。
クチベタ	話の仕方が下手なこと。
クチモト	口の辺り。
クチヨウ	話し方の調子。
クツ	足を包み、厚い底の付いたはき物。
クツウ	肉体や心に感じる痛みや苦しみ。
クツキング	料理。料理法。
クツキー	砂糖・卵・バター・小麦粉などを混ぜて作る洋菓子。
クツシタ	皮膚の保護や保温のために直接足につける衣料。ソックスやストッキングなど。
クツジヨク	力でおさえられて受ける、はずかしさ、くやしさ。はずかしめ。
クツセツ	光などが折れ曲がること。
クツベラ	靴をはくとき、足を入れやすくするためのへら。
クツミガキ	靴をみがくこと。また、それを職業とする人。
クトウテン	文の意味をはっきりさせたり、読みやすくするための「、」や「。」のこと。
クニ	地球上の一定の地域に住む人々が一つの組織としてまとまったもの。
クノイチ	女性の忍者。
クビ	動物の頭と胴をつないでいる部分。人間や動物の肩から上の部分。
クビカザリ	宝石や貴金属をつないで首にかける装飾品。ネックレス。
クビワ	犬やネコの首にはめる輪。
クフウ	新しいやり方、うまい方法を考え出してやってみること。
クベツ	物事を種類・性質などのちがいによって分けること。
クボミ	周りよりへこんだ所。くぼんでいる所。
クミ	まとまり。学級。クラス。
クミアワセ	いくつかのものをあわせて組を作ること。
クミタテ	組み立てること。組み立てたもの。
クモ	大気中の水蒸気が冷えて、細かい水や氷のつぶになり、それらが集まって空気中に浮かんでいるもの。
クモユキ	雲の動き。
クモリ	雲が空をおおっている天気。光を通したり、反射したりしなくなること。
クラ	家財・商品などをしまっておくための建物。
クラゲ	骨がなく海の中をゆらゆらただよう動物。
クラシ	暮らすこと。生活する様子。
クラス	学級、組。階級。
クラツカー	塩で味をつけ、薄くかたく焼いたビスケット。
クラブ	趣味・スポーツ・研究などで、同じ目的を持った人の集まり。
クラヤミ	やみのように暗いこと。
クリ	野山に生える落葉樹。実がいがいがのとげで包まれている。
クリカエシ	同じことを何度もすること。
クリスマス	イエスキリストの誕生を記念する祝祭。十二月二十五日。
クリツク	コンピューターでマウスのボタンを押してすぐ離すこと。
クリツプ	書類などをはさむための小さな金具。
クリニツク	英語で診療所のこと。
クリーム	どろどろした食べ物。ぬり付ける物。
クルマ	一本の心棒を中心にして回る輪。自動車。
クルマイス	歩行が困難な人が腰かけたまま動けるように、いすに車輪をつけたもの。
クルミ	かたいからにおおわれた実を付ける落葉高木。食用。「○○○割り人形」
クレヨン	ろうや油を混ぜて固めた、棒のような絵の具。
クレンザー	研磨剤・洗剤などをまぜて作った、みがき粉。
クレープ	小麦粉に牛乳・卵などを加えてとき、ごく薄く延ばして焼いたもの。
クレーン	重い物をつり上げて移動させるための機械。
クロ	墨のような色。
クロシオ	日本列島の東海岸に沿い、南から北に流れる暖流。
クロジ	黒く書かれた文字。収支決算がプラスになること。
クンシヨウ	国が功労のあった人に授ける記章。
クンセイ	塩づけした肉を煙でいぶし、乾燥させた食品。
クンリン	君主として国を治めること。
クンレン	ある能力や技術を習得させるために、教えて練習させること。「避難○○○○」
クーラー	空気などを冷やす機械。
グアイ	物事がうまくいっているかどうかの様子。調子。体調。機械などの調子。
グウスウ	二で割り切れる整数。
グウゼン	因果関係もなく、思いがけなくそのようになること。
グラタン	肉・野菜などを焼き皿に入れホワイトソースをかけてオーブンで焼いた料理。
グラフ	二つ以上の数量をひと目で見比べることができるように、図で表したもの。
グラム	メートル法で重さを表す単位。一円玉と同じ重さ。
グリーン	英語で緑色のこと。
グルメ	食通。美食家。
グループ	集団。仲間。
グレー	灰色。ねずみ色。
グレープ	英語でぶどうのこと。
ケアナ	皮膚の表面にある、毛の生える穴。
ケイイ	物事のなりゆき、いきさつのこと。
ケイエイ	目的を持ち、計画を立てて、責任を持って事業を行うこと。
ケイカ	年月時間が過ぎていくこと。
ケイカイ	悪いことが起こらないように、用心して備えること。
ケイカク	あることを行うために、あらかじめその手順・方法などを考えること。またはその考え。
ケイカン	すばらしいながめ。
ケイキ	世の中のお金の流れ。商売の具合。
ケイケン	自分で実際に見たり、聞いたり、やってみること。
ケイゲン	軽くしたり、減らしたりすること。
ケイコ	技術などを習うこと。練習をすること。
ケイコウ	性質や状態がある方向にかたむいていること。
ケイコク	悪いことが起こらないように、前もって注意をあたえること。
ケイゴ	人を敬う気持ちを表すときに使う言葉づかい。
ケイサイ	新聞や雑誌に、文章・絵・写真などを載せること。
ケイサツ	国民の生命・身体・財産の保護、犯罪の予防・捜査、社会秩序の維持を目的とする組織。
ケイサン	物の数量を数えたり、式を解いて答えを出すこと。
ケイザイ	人間の共同生活に必要な物資・財産を生産・分配・消費する活動。金銭のやりくり。
ケイシヤ	かたむいてななめになること。
ケイシヨウ	症状が軽いこと。
ケイシヨク	簡単にすませる軽い食事。
ケイジバン	伝達事項などの文書を掲示するための板。
ケイジヨウ	物の形。
ケイセン	項目を囲ったり、仕切るために縦や横に引かれた直線。
ケイゾク	引き続いて行うこと。とちゅうでやめないこと。
ケイタイ	手に持ったり、身に付けたりして持ち歩くこと。
ケイト	セーターなどの編み物をするための太めの糸。
ケイド	物事の程度が軽いさま。
ケイハツ	気付かない点を教え示して、より高い認識や理解に導くこと。
ケイヒ	物事を行うのにかかる一定の費用。
ケイヒン	遊戯などの得点者に与える品物。客に無料で贈る品物。おまけ。
ケイビ	悪いことが起こらないように、用心して守ること。
ケイホウ	危険なことが起こりそうなとき、前もって注意し、用心させる知らせ。
ケイボウ	警察官が装備として携行する木製の棒。
ケイモウ	人々に正しい知識を与え、ものの道理がわかるように導くこと。
ケイヤク	二人以上の間で、法律に裏付けられた約束を結ぶ行為。
ケイヨウ	物事の様子や性質などを、言葉を使って言い表すこと。
ケイラン	ニワトリの卵。
ケイリヨウ	目方・長さなどの、物の量をはかること。
ケイリン	職業選手による自転車競走。または、その着順を予想して行うばくち。
ケイレイ	敬意を表して礼をすること。
ケイレン	筋肉が発作的に収縮すること。
ケイロ	物事がたどってきた道すじ。
ケイロウ	老人をうやまい、大切にすること。「○○○○の日」
ケガワ	毛がついたままの、けものの皮。
ケサ	今日の朝。
ケシイン	郵便局などで、使用済みの印としておす、年月日の付いたスタンプ。
ケシキ	自然の眺め。風景。
ケシゴム	えんぴつなどで書いた字や絵を消すためのゴム。
ケシヨウ	顔におしろい・紅などを塗って美しく見えるようにすること。
ケジメ	ある物事と他の物事の正しい区切り。
ケタ	数の位取り。建物・橋などの柱の上に横に渡して、他の部材を支える材。
ケチヤツプ	熟したトマトを煮つめたものに、味を付けた調味料。
ケツイ	自分で考えをしっかり決めること。はっきり決めた意志。
ケツエキ	動物の体内を流れて、栄養などを送る液体。
ケツカ	できばえ。ある物事がもとになって起こること。
ケツカン	血液が流れる管。
ケツコウ	定期的に発着している船舶や航空機が運航を取りやめること。
ケツコン	男と女が夫婦になること。
ケツサク	すぐれた作品。
ケツサン	金銭の収支を計算してまとめること。また、その計算。
ケツシヨウ	競技などで一番すぐれた者を決めること。
ケツシン	あることをしようと心を決めること。
ケツジヨ	あるべきものが欠けていること。
ケツセイ	何人かが集まって会などを作ること。
ケツセキ	学校や集会に出ないこと。休むこと。
ケツダン	迷わないで、はっきりと態度や考えを決めること。
ケツチヤク	物事の決まりをはっきりとつけること。
ケツテイ	物事をはっきり決めること。
ケツテン	足りないところ。悪いところ。
ケツベン	血液のまじった便。
ケツマツ	物事の終わり。しめくくり。
ケツロン	話し合いや議論などの結果、決められた意見。最後のまとめの意見。
ケナミ	毛の生えている具合。
ケヌキ	毛髪・ひげ・とげなどをはさんで抜き取る金属製の道具。
ケネン	どうなるのか気がかりで、心配すること。不安。
ケハイ	見えないけれど、なんとなく人がいたり、何かが起こりそうな感じがすること。
ケムシ	全身に毛がある虫。
ケムリ	物が燃えるときに空中に出てくる、色のある気体。
ケモノ	全身に毛が生えた、四本足の動物のこと。
ケンイ	すぐれたものとして人を従わせる力。他の人々よりすぐれた知識・技術を持っている専門家。
ケンイン	物をひっぱること。引き寄せること。
ケンエツ	よく目を通して調べること。国家が本や映画などの内容を調べること。
ケンカイ	ある物事についての評価や考え方。
ケンガク	実際に目で見て学ぶこと。
ケンキユウ	ある物事についてくわしく調べ、その内容を明らかにすること。
ケンキヨ	知識や能力があっても、いばらず、すなおなさま。謙そん。
ケンケツ	輸血用の血液を無償で提供すること。
ケンコウ	体に異常がなく、元気なさま。
ケンコク	新しく国家を作ること。「○○○○記念の日」
ケンサ	物のいい悪いなどを一定の決まりにしたがって調べること。
ケンサク	インターネットなどで調べて探し出すこと。
ケンザン	計算した後、もう一度計算してその正誤を確かめること。
ケンシヨウ	いろいろ調べて事実を証明すること。
ケンシン	病気の有無を調べるために診察や検査をすること。
ケンジヨウ	身分の高い人に品物などを差し上げること。
ケンスウ	事件や事がらの数。
ケンセイ	相手の注意を引き付けておいて、自由に行動できないようにすること。
ケンセツ	建物などを新しく作ること。
ケンゼン	体がじょうぶでしっかりしているさま。考えや行いが正しくしっかりしているさま。
ケンチク	家などを建てること。
ケンチヨウ	県の行政事務を取り扱う役所。
ケンテイ	人を試験にかけ、合格か不合格か、等級などを決めること。
ケントウ	くわしく調べて、それでいいかどうかをよく考えること。
ケンドウ	日本に古くからある、剣を使った武道。
ケンニヨウ	病気の有無や病状を知るために尿を検査すること。
ケンバン	ピアノ・オルガンなどで指でたたくところ。キーボード。
ケンブツ	楽しみのために、物や景色などを見ること。観光。
ケンポウ	国の政治の仕方や、国民の権利や義務などについて定めた、国家の最高の決まり。
ケンマ	表面を研ぎ磨くこと。
ケンミン	その県の住民。
ケンム	本務のほかに別の職務も兼ねること。
ケンメイ	力をつくしてがんばること。
ケンヤク	無駄づかいをしないこと。節約。
ケンヨウ	一つのものを二つ以上の用途に使うこと。
ケンリ	物事を自分の意思で行うことができる資格。
ケンリヨク	他人を支配し、服従させる力。
ケーキ	小麦粉に卵・バター・ミルクなどを混ぜて焼いた洋菓子。
ケース	容器。入れ物。事例。
ゲイシヤ	歌舞・音曲などで宴席をとりもつことを職業とする女性。
ゲイシユン	新春を迎えること。
ゲイジユツ	人間が美しいと感じたり、思ったことを文章や音、形などにすること。または、その作品。
ゲイニク	くじらの肉。
ゲイメイ	芸能人が用いる、本名以外の名前。
ゲカ	病気やけがを手術などによって治療する医学分野。
ゲキ	演劇。芝居。ドラマ。
ゲキカ	前よりもはげしくなること。はげしくすること。
ゲキゲン	数や量が急激に減ること。
ゲキジヨウ	演劇や映画を見るために作られた建物。
ゲキセン	激しく戦うこと。また、その戦い。
ゲキダン	演劇の上演・研究を目的に組織された団体。
ゲキトツ	はげしくぶつかること。
ゲキド	はげしく怒ること。
ゲキム	非常に忙しく、心身の負担が大きい仕事。
ゲキリユウ	激しい勢いの流れ。
ゲキロン	激しく議論すること。また、その議論。
ゲコウ	勉強が終わって学校から帰ること。
ゲザイ	便秘のときなど、おつうじをよくするために飲む薬。
ゲスト	英語でお客さんの意味。
ゲタ	木をくりぬいて鼻緒（はなお）をつけた、日本特有のはき物。
ゲツカン	毎月一回定期的に発行すること。また、その刊行物。
ゲツガク	一か月当たりの金額。
ゲツコウ	月の光。
ゲツシユウ	一ヶ月の収入。
ゲツシヨク	太陽・地球・月が一直線にならび、地球の影の中に月が入って、月の一部または全部が見えなくなる現象。
ゲツヨウ	日曜日の次の日。
ゲレンデ	スキーの練習場。滑走場。
ゲンイン	物事の起こるもと。
ゲンエキ	現在、仕事や地位についていて、活躍を続けていること。
ゲンカイ	これ以上できないという境目。
ゲンカン	建物の正面の出入り口。
ゲンガク	金額を減らすこと。
ゲンガツキ	弦の振動によって音を発する楽器。
ゲンキ	心や体を活動させる力。体が健康なさま。
ゲンキン	手元に持ち合わせているお金。
ゲンコウ	印刷したり、講演をしたりするときのもとになる文章を紙に書いたもの。
ゲンゴ	言葉や文字の体系。言葉の種類。
ゲンザイ	今。ただ今。
ゲンシ	元素を構成する最小単位。アトム。
ゲンシカク	原子の中心部を構成するもの。
ゲンシジン	原始時代の人類。
ゲンシユ	きびしく守ること。
ゲンシヨウ	現れて見える形やありさま、出来事など。
ゲンジツ	頭の中で考えたものではなく、今、現にあること。実際にあること。
ゲンジユウ	いいかげんではなく、厳しい上にも厳しく行うさま。
ゲンセキ	採取されたままで、まだ加工していない宝石や鉱石。
ゲンセン	基準をきびしくして選ぶこと。
ゲンゼイ	税額が減ること。税額を減らすこと。
ゲンソ	化学的にそれ以上は分解できない物質。
ゲンソウ	実際にはありえないことを現実の事がらのように想像すること。「○○○○曲」
ゲンソク	基本的な方針となっている規則。
ゲンダイ	今のこの世の中。今の時代。
ゲンテン	点数を減らすこと。
ゲンド	それ以上はこえられない区切り。許される範囲。
ゲンドウ	言葉と行動。
ゲンバ	物事が行われる場所。現地。
ゲンマイ	もみがらを取っただけで、精白していない米。
ゲンミツ	細かいところまで、厳しく気を配るさま。
ゲンユ	地中から採掘したままで、まだ精製していない石油。
ゲンリ	物事の大もとのりくつや仕組み。
ゲンリヨウ	品物を作ったり加工したりするときの、もとになる材料。
ゲンロン	意見や思想を話したり文章に書いたりして公表すること。「○○○○の自由」
ゲート	英語で門、出入り口、関門のこと。
ゲーム	得点や勝ち負けを争う遊び。スポーツの試合。
コイル	電気が通る線をらせん状に巻いたもの。
コイン	英語で硬貨のこと。
コウアツ	高い電圧。高い圧力。
コウアン	くふうをめぐらして、新しく何かを考え出すこと。
コウイ	行い。または、行ったこと。
コウウン	運がいいこと。ラッキー。
コウエン	人々のいこいの場としてつくられた広い庭のような場所。
コウオン	高い温度。
コウカ	学校の歌として正式に定められたもの。
コウカイ	前にしたことについて、後になってから自分が悪かった、まちがえたと残念がること。
コウカン	おたがいに物と物を取りかえること。取りかえ。
コウガク	大きな金額。大金。
コウキアツ	大気中で周囲よりも気圧が高い所。
コウキシン	もの好きな心。めずらしいものや、不思議なものを知りたいと思う心。
コウキユウ	品質・等級などがすぐれていること。
コウキヨウ	世の中全体。社会全体の人々。おおやけ。
コウキン	有害な細菌が増えるのを抑えること。
コウギ	相手の考えや行いに対して、反対の意見を強く言い張ること。
コウギヨウ	生産された材料を加工して、製品を作り出す産業。
コウクウ	飛行機などで空を飛ぶこと。
コウグ	工作に使う道具。特に、機械工作に使う刃物類。
コウケイ	その場の様子。ありさま。風景。
コウケイキ	経済活動が活発で金回りがよいこと。景気がいいこと。
コウケン	おおやけのことのために力をつくし、役に立つこと。
コウゲン	広い土地にあって、野原のように広々とした所。
コウコウ	高等学校の略。
コウコク	客をよびよせたり、商品を売ったりするために、広く世間に知らせること。
コウゴ	話すときに使われる言葉。文語の対義語。
コウサ	二つ以上の線状のものが一点で交わること。「○○○点」
コウサイ	人と人が付き合うこと。
コウサク	かんたんな品物や道具などを作ること。またはそれを学ぶ教科。
コウサテン	二本以上の道路などが交わっている所。十字路。
コウシ	小さな牛。
コウシヤ	教室などがある学校の建物。
コウシヨ	高い所。「○○○○恐怖症」
コウシン	たくさんの人が列を作り、そろって歩いていくこと。パレード。
コウジ	建物や道路などを作ったり直したりする仕事。
コウジユツ	口頭で述べること。
コウジヨウ	多くの人をやとい、機械などを使って物を作ったり、加工したりする所。
コウスイ	いい香りのする液体。衣服や体などにふき付けて使う。
コウズイ	川などの水があふれること。
コウセン	光の筋。
コウソ	生体における化学反応の触媒となるたんぱく質を中心とした高分子化合物。
コウソウ	考えを組み立て、まとめること。
コウソク	その学校の生徒が守るように決められている規則。
コウゾウ	物事の組み立てられ方。
コウタイ	人がたがいに入れ替わること。人を入れ替えること。
コウタク	物の表面のつや。
コウチ	水田・畑など、農作物を耕作する土地。
コウチク	組み立てて築くこと。
コウチヤ	茶の若葉をつみとって発酵させ、かわかしたもの。お湯を通すと赤っぽい色が出てくる。
コウチヨウ	学校の先生の中で一番上に立つ先生。
コウツウ	人や車が道路を行ったり来たりすること。
コウツゴウ	条件・要求などにかなっていて、都合がよいこと。
コウテイ	学校の運動場や庭。
コウテツ	硬くてじょうぶな鉄。
コウテン	二つ以上の線がたがいに交わるところ。
コウトウ	考えていることを紙に書かずに口で言うこと。
コウド	海水面からの高さ。海抜。程度が高いさま。
コウドウ	何かを行うこと。
コウドク	新聞・雑誌などを買って読むこと。
コウナイ	学校の中。
コウニユウ	買い入れること。
コウニン	正式に許すこと。
コウネツ	非常に高い温度。異常に高い体温。
コウネンキ	成熟期から老年期へ移行する時期。
コウノウ	薬などの働きによって現れる、よい結果。効き目。
コウハイ	年下の人。
コウハク	赤組と白組。赤と白。
コウハン	物事を二つに分けたときの後ろの半分。
コウバン	警官が見回りなどをするために、町のところどころに設けられた詰め所。派出所。
コウヒ	官庁または公共団体の費用。
コウヒヨウ	表向きにみんなに発表すること。
コウフク	何不自由なく、満ち足りているさま。幸せ。幸い。
コウフン	感情が高ぶること。
コウブツ	好きなもの。特に食べ物や飲み物について言う。
コウヘイ	かたよったり、えこひいきしたりしないさま。
コウホ	ある地位や身分を得る資格があるものとして、選ばれたもの。選挙に立候補した人。
コウホウ	工事・建築などで、工事の方法。
コウム	おおやけの仕事。国や市町村のする仕事。「○○○員」
コウムイン	国または地方自治体の公務に従事する人。
コウモク	記事や記録などを細かく分けたときの一つ一つの部分。
コウモリ	鳥のように空を飛ぶ小さな動物。逆さにぶら下がって休み、ほらあななどにすむ。
コウモン	学校の門。
コウヤク	選挙のとき、政党・候補者などが人々に政策の実行などを約束すること。
コウヨウ	木の葉が秋になって赤くなること。
コウラ	カメ・カニなどの背中をおおうかたい殻。甲。
コウリ	仕入れた商品を消費者に直接販売すること。
コウリツ	地方公共団体が設立し、管理・運営すること。
コウリユウ	おたがいに交わることや、行き来すること。
コウリヨ	よくよく考えること。
コウリヨウ	いいにおいを出す材料。
コウレイ	非常に年をとっていること。
コウレイカ	総人口のうち、六十五歳以上の高齢者の割合が次第に高くなっていくこと。
コエ	人や動物がのどから出す音。
コエガワリ	思春期のころ、声帯が変化して音声・声域などが変わること。
コオリ	温度が低くなって、水などが固まった冷たいもの。
コカゲ	木の下の日光や雨の当たらないところ。
コガイシヤ	資本参加・役員派遣などによって、他の会社の支配下にある会社。
コガタ	型が小さいこと。
コガタナ	工作などに使う小さな刃物。ナイフ。
コガラ	体が小さい様子。
コキザミ	動き具合が小さくて速いこと。小さく区切ること。
コキヤク	ひいきにしてくれる客。得意客。クライアント。
コキユウ	息を吸ったりはいたりすること。
コキヨウ	生まれ育った土地。ふるさと。
コクエキ	国家の利益。
コクエン	黒い色のけむり。
コクオウ	国を治める王様。君主。
コクガイ	国の境目から外。「○○○○追放」
コクゴ	学校で「読む・書く・話す」言葉の学習をする科目。
コクサイ	国と国、または世界の多くの国々に関係すること。
コクサク	国家の基本政策。
コクサン	自分の国で作られた物。
コクセイ	国の政治。
コクセキ	人や物がどの国に属するかということ。
コクチ	告げ知らせること。通知。
コクテン	太陽の表面に現れる黒い点。
コクド	その国の土地。領土。
コクドウ	国が建設し、維持・管理する幹線道路。
コクナイ	国の中。
コクハク	心にかくしていたことを打ち明けること。
コクバン	チョークなどで文字や絵をかくための板。
コクフク	むずかしいことや苦しいことに打ち勝つこと。
コクホウ	国が宝物として選んで決め、大事にするもの。
コクミン	その国の籍を持ち、その国の決まりにしたがって生活し、その国を作っている人々。
コクモツ	人間が食べる米や麦、ひえ、あわなど、田畑からとれる穀類の作物。
コクユウ	国家が所有すること。
コクリツ	国が設立・維持・管理すること。
コクリヨク	一国が持つ軍事力・経済力などの総合的な勢力。
コケ	日かげやしめった土地に生える小さな植物。
コケイ	液体や粉の状態ではなく、ある形に固まっているもの。固体。「○○○物」
コゲ	物が焼けてこげること。
コゲメ	こげた跡。
ココア	カカオ豆を、いって粉にしたもの。飲み物やチョコレートの原料。
ココノツ	一つの九倍。八つの次の数。九歳。
ココロ	考えたり感じたり思ったりするはたらき。気持ち。
ココロエ	守らなければならない、知っていなければならない基本的なこと。決まり。
ココロザシ	やろうとして心の中で決めたこと。
ココロミ	ためし。試みること。
コゴ	古い時代の言葉で、今では一般に使われなくなった言葉。
コゴエ	小さな声。
コゴト	口やかましく言って聞かせる言葉。不平などをぶつぶつ言うこと。
コサメ	少し降る雨。細かく降る雨。
コザイク	手先を使ってする、こまごまとした細工。
コザカナ	小さな魚。雑魚。
コザラ	小さい皿。
コシ	背中としりの間のところ。
コシカケ	こしをかけるための台やいす。
コシツ	一人だけで使う部屋。
コシヨウ	機械などがこわれること。
コジン	一人ひとりの人間。
コジンサ	個人によって違いがあること。
コスウ	一つ二つ、一個二個と数えられる物の数。
コスト	英語で費用のこと。
コスプレ	アニメ・漫画などに登場するキャラクターなどの扮装をして楽しむこと。
コセイ	その個人や物だけが持っている特長や性質。特性。
コセキ	国民一人ひとり、および各家族の名前、生年月日、間がらなどを記録してある公式の書類のこと。
コゼニ	小額の貨幣。細かいお金。
コソク	根本的な解決をせず、一時の間に合わせにすること。「○○○な手段」
コゾウ	年の若いぼうさん。少年をばかにしたり、しかったりするときの言葉。
コタイ	石や氷のように一定の形に固まっている物。
コタエ	問題の解答。
コタツ	ふとんの中に足を入れて、足を温める道具。
コダイ	古い時代。
コダイコ	小型の太鼓。
コダカラ	宝のように大切な子ども。
コダクサン	夫婦の間に子どもがたくさんあること。
コチ	東から吹いてくる風。
コチヨウ	事実より大げさに表現すること。
コツカ	国のこと。一定の土地と、そこに住んでいる人々によって形作られ、治められている集団。
コツカイ	国民によって選挙された議員で構成する国の議会。
コツカク	体を支える骨組み。
コツキ	国のしるしとなる旗。
コツキヨウ	国と国の境。
コツク	レストランなどの料理人。水やガスを出す口のところに付いているせん。
コツケイ	言うことや動作がおどけていて、おかしいさま。
コツコウ	国家間の公式の交際・交流。
コツコツ	ある一つの物事に対して、着実に努力する様子。
コツセツ	体の骨が折れること。
コツブ	粒が小さいこと。小さなつぶ。
コツプ	飲み物などを入れる容器。
コヅカイ	ちょっとした買い物などに使うお金。
コヅツミ	小さい包み。品物を紙などに包んで、遠くに送るもの。
コテ	ひじと手首の間。または手首。剣道の技の一つ。
コテイ	ある場所から動かないように、しっかりと落ち着かせること。
コトシ	この年。
コトバ	人間が、自分の気持ちや思っていることを相手に伝えるため、音声や文字を使って表すもの。
コトブキ	めでたいこと。祝い。祝いの言葉。長寿。
コトリ	小さな鳥。
コトワザ	むかしから言い伝えられてきた、教えなどを短く表した言葉。格言。
コドク	一人ぼっちでさびしい心の状態。
コドモ	自分の子。小さい幼いもの。
コドモヅレ	子どもを連れていること。また、その人。
コナ	非常に細かくくだいたもの。粉末。
コナミルク	牛乳を濃縮し、乾燥させて粉末にしたもの。ドライミルク。
コナユキ	粉のようにさらさらにして細かい雪。
コノミ	好きだと思うこと。
コハク	古代の樹脂が地中に埋没して石化したもの。
コバチ	小さな鉢。
コバナレ	子どもの成長に伴って、親がその自主性を尊重するようになること。
コビト	体が非常に小さな人。
コピー	書類や原稿を写し取ること。または、その写し。複製したもの。
コフン	土を高く盛り上げて造った古代の墓。
コブ	肉がもり上がったところ。
コブトリ	少し太っていること。
コブリ	雨や雪が少しだけ降っている様子。
コボネ	細くて小さな骨。
コマ	軸を中心にして回るように作ったおもちゃ。
コマク	耳の奥にある、音を聞き取るためのまく。
コマワリ	半径を小さくして回ること。
コミチ	はばのせまい小さな道。
コミツク	漫画本。
コムギ	稲とならんで重要な穀物。パンやうどんの原料。
コムギコ	小麦を粉にしたもの。
コメ	稲の実から、もみがらを取り除いたもの。日本人の主食。
コメカミ	耳の上、目のわきの、物をかむと動く部分。
コメツブ	米のつぶ。
コメデイー	英語で喜劇のこと。
コメント	あることについて意見や見解を述べること。論評。
コモジ	小さな文字。ローマ字で小さな形の字。
コモリ	子どもをあやしたり、世話をしたりすること。
コヤ	小さくてそまつな家。
コヤギ	子どものヤギ。
コヤク	映画・演劇・テレビなどで子どもの役、またはそれを演じる子どもの役者。
コヤシ	作物の生育をよくするために土壌などに施す栄養分。肥料。
コユキ	少しの雪。少し降る雪。
コユビ	手足の五本の指の中でもっとも細くて小さい指。
コヨウ	賃金を払って人をやとうこと。
コヨミ	一年間の月・日・曜日などを日を追って記したもの。カレンダー。
コラボ	共同作業。○○○レーションの略。
コリツ	だれの助けもなく、一人だけぽつんとはなれてしまうこと。
コリヨウリ	ちょっとした料理。
コルク	軽くやわらかくて、びんの栓などに使われる木の皮。
コレクター	収集家。
コロツケ	ゆでてつぶしたジャガイモ・ひき肉などを混ぜて丸め、パン粉を付けて油であげた料理。
コロモ	てんぷら・フライなどで、たねの外側を包むもの。
コロモガエ	時候の変わり目に、季節に合った衣服に着替えること。
コンイン	男女が結婚すること。また、結婚している状態。
コンカイ	このたびの回。今度の回。
コンガン	心をこめてたのむこと。
コンキ	一つのことをずっと続ける気力。
コンキヨ	考えなどのもととなる理由。よりどころ。
コンクラベ	根気の強さを競い合うこと。
コンクール	競技会。競演会。
コンゲツ	今すごしている月。
コンゴ	今から後。
コンサート	音楽会。演奏会。
コンザイ	入り混じって存在すること。
コンザツ	人や物がこみ合い、ごたごたしているさま。
コンシユウ	今すごしている週。
コンシユン	今年の春。この春。
コンジヨウ	物事をなしとげようとする強い精神力。特有の性質。
コンセキ	過去に何事かあったことを示す跡。
コンセプト	概念。観念。広告・企画・新製品などの全体をつらぬく、基本的な考え方。
コンダテ	料理の種類・組み合わせ・順序などの計画。メニュー。
コンチユウ	体が頭・胸・腹の三つに分かれ、三対の足を持つ虫。
コンテスト	ある事がらのうち、どれがすぐれているかをきそい合う会。
コンド	このたび。今回。この次。
コンドウ	区別しなければならないものを区別せずに、まぜこぜにあつかうこと。
コンナン	苦しくこまること。つらくて苦しいこと。物事をなしとげるのがむずかしいさま。
コンニチハ	昼間、人に会ったり人の家をたずねたりするときに使うあいさつの言葉。
コンバン	今日の晩。
コンバンハ	夜、人に会ったり、人の家をたずねたりしたときに使うあいさつの言葉。
コンパ	仲間で費用を出し合って飲食する親睦会。
コンパス	円をかくときに使う道具。方角を示す羅針盤。
コンビニ	「コンビニエンスストア」の略。
コンブ	褐色を帯びる革状の海藻。だしがとれる。
コンペ	ゴルフの競技会。公募によるデザインの競技会。
コンボウ	太く長い木の棒。武器などとして用いる棒。
コンポウ	包み込んで荷造りをすること。包装し、なわなどをかけて荷造りをすること。
コンヤ	今日の夜。
コンヨク	男女が同じ浴場で一緒に入浴すること。
コース	道。道順。競走や競泳などで走ったり泳いだりする道筋。進路や方角。
コーチ	スポーツの技術などを指導すること。または指導する人。
コード	ゴム・ビニールなどで巻いた電線。
コーヒー	こげ茶色の苦味の強い飲み物。
コーラス	合唱。合唱団。合唱曲。
ゴイシ	囲碁で使う、白と黒の石。
ゴウイ	おたがいの意思・意見が一致すること。
ゴウウ	激しい勢いで降る大量の雨。
ゴウカ	いかにも派手でぜいたくなこと。
ゴウカク	試験に受かったり、決まった条件や資格にかなうこと。
ゴウガイ	突発的な大事件などを伝えるために、臨時に発行する印刷物。
ゴウキユウ	大きな声を上げて泣きさけぶこと。
ゴウキン	二つ以上の金属をとかし、混ぜ合わせて作った金属。
ゴウケイ	二つ以上の数量を足し合わせること。足し合わせた結果。
ゴウゴ	意気盛んに大きなことを言い放つこと。
ゴウセイ	二つ以上のものを合わせて一つのものを作り出すこと。
ゴウセツ	きわだって多い降雪。
ゴウテイ	大きくて立派な邸宅。
ゴウドウ	二つ以上の図形が形も大きさも同じであること。
ゴウヒ	合格と不合格。合格か不合格か。
ゴウユウ	惜しげもなくお金を使って、豪勢に遊ぶこと。
ゴウヨク	非常に欲が深いこと。
ゴウリユウ	二つ以上の流れが集まって、一つの流れになること。
ゴカイ	まちがって理解すること。
ゴカク	双方の力量に優劣の差がないこと。
ゴガク	言葉を研究する学問。
ゴガツ	一年で五番目の月。
ゴキゲン	非常に気分がいいさま。
ゴクヒ	絶対に他人に見せたり、知らせたりしてはいけないこと。
ゴクラク	何の苦労もなく、とても楽しいところ。
ゴゲン	単語が成立した由来や起源。
ゴゴ	正午から夜の十二時までの間。
ゴサ	真の値と計算・測定して得た近似値との差。
ゴジツ	後の日。
ゴゼン	夜中の十二時から正午までの間。
ゴチソウ	食事などをふくまってもてなすこと。ぜいたくな食事。ぜいたくな料理。
ゴツカン	きわめて寒いこと。
ゴハン	お米をたいたもの。食事のこと。
ゴマ	ご飯にかける小さな種子。白○○、黒○○などがある。油は大変香りがよく、揚げ物などに使われる。
ゴマシオ	炒った黒ゴマと塩をまぜたもの。
ゴミ	いらなくなってすてるもの。くず。
ゴム	弾性に富み、絶縁体の性質を持つ物質。
ゴメン	相手に軽くあやまるときの言葉。
ゴヨウ	方法・用法などをまちがって使うこと。また、まちがった使い方。
ゴラク	人を楽しませ、なぐさめるもの。
ゴリラ	類人猿で最も大きな猿。
ゴルフ	小さな玉を打ち、遠くにある穴に入れる競技。
ゴルフアー	ゴルフをする人。
ゴロネ	寝具を使わず、その場にごろりと横になって寝ること。
ゴール	目標にしている最後の地点。
ゴールド	金。黄金。金色。
サイ	鼻の上に一本から二本の角がある、大きな体で灰褐色の動物。
サイアイ	一番かわいがり、大切にしていること。
サイエンス	科学。自然科学。
サイカイ	一時休んだり、閉じていたことを再び開くこと。
サイキヨウ	最も強いこと。
サイキン	細胞がたった一つのごく小さい生物。
サイクツ	地中の鉱物などを掘って取ること。
サイケツ	病気の診断や輸血の目的で、体内から血液をとること。
サイケン	建物を建て直すこと。
サイコ	一番古いこと。
サイコウ	もう一度考えてみること。考え直すこと。
サイコロ	すごろくなどで使う道具。小型の立方体で各面に一から六までの目が刻んである。
サイコン	再び結婚すること。
サイゴ	一番あと。いちばん終わり。
サイサン	入ってくるお金と出ていくお金のつり合い。
サイシ	妻と子。
サイシユ	研究・調査などの目的で必要なものを選びとること。また、選んで集めること。
サイシユウ	一番終わり。
サイシヨ	一番初め。
サイシヨウ	一番小さいこと。
サイシン	一番新しい。
サイズ	英語で大きさ、寸法のこと。
サイセン	ふたたび選挙などで選ばれること。
サイゼン	いくつかある中で一番いいこと。
サイソク	早くするようにと、急がせること。
サイタ	最も多いこと。
サイタン	一番短いこと。
サイダイ	一番大きいこと。
サイダー	炭酸水に香りや砂糖などを加えて作った飲み物。
サイチユウ	物事をしているとちゅう。
サイチヨウ	一番長いこと。
サイテイ	もっとも悪いこと。一番低いこと。
サイテキ	もっとも適していること。
サイテン	点数を付けること。
サイド	再び。もう一度。
サイニン	もう一度前と同じ役職につくこと。
サイノウ	何かをやりとげることができる頭のはたらきや腕前。
サイバイ	植物を植えて育てること。
サイフ	お金を入れて持ち歩くための小さい入れ物。
サイブ	こまかい部分。
サイホウ	布地を裁断して衣服などに縫い上げること。針仕事。
サイボウ	生物の体を作っている一番小さな単位。
サイマツ	年の暮れ。年末。
サイミン	眠くなること。また、ねむけをもよおさせること。「○○○○術」
サイム	債権に対応する債務者の義務。
サイヨウ	いいものを採り上げて用いること。
サイライ	再び来ること。
サイリヨウ	もっとも良いこと。
サイルイ	涙を出させること。「○○○○ガス」
サイレン	大きな音を出す装置。または、その音。
サイワイ	幸せなこと。幸運をもたらす様子。運がよかったという気持ちを表す言葉。
サイン	自分の名前を書くこと。署名。
サカ	一方が高く傾斜があり、人や車が上り下りしている道。
サカイ	場所などの区切り。物事の別れる部分。
サカイメ	さかいとなる所。区切りとなる所。分かれ目。
サカサ	物の上下・左右・表裏・前後などの位置が逆になっていること。
サカサマ	物の上下・左右・表裏・前後などの位置が逆になっていること。
サカダチ	両手を地につけて体を支え、両足を上にのばして逆さまに立つこと。
サカダル	酒を入れておくたる。
サカナ	海・川・湖などにすむ動物。
サカバ	客にお酒を飲ませる店。
サカミチ	坂になっている道。
サカリバ	いつもたくさんの人が集まっている、にぎやかな場所。繁華街。
サガク	差し引きした残りの金額。
サキガケ	他のものより先になること。
サキドリ	他人より先に物を取ったり、物事を行うこと。
サキユウ	風に運ばれてきた砂が堆積してできた丘。
サキユキ	今後のなりゆき。行く末。
サキン	砂粒のようになった金。
サギヨウ	仕事をすること。
サク	木や竹を組んで作った囲い。
サクゲン	けずって減らすこと。
サクシ	詩や歌の文句を作ること。
サクシヤ	小説・詩などの作品を書いた人。
サクシユ	しぼって汁などをとること。
サクジツ	今日の前の日。きのう。
サクジヨ	文章などの一部をけずり、取り除くこと。
サクズ	図面や図形をかくこと。
サクセイ	作ること。
サクセン	試合や争いなどをうまく進めるための計画や方法。
サクネン	今年の前の年。去年。
サクヒン	小説・音楽・絵・詩などの芸術品。
サクブン	文章を作ること。
サクヤ	きのうの夜。昨晩。
サクラ	白やピンクの花をたくさん咲かせる木。日本の国花。
サクラン	頭が混乱すること。
サクランボ	サクラの実のこと。
サクリヤク	相手をおとしいれるためのはかりごと。
サケ	アルコールが入っている飲み物。
サケカス	もろみから酒をしぼったあとの残りかす。
サケノミ	酒が好きでたくさん、またはしょっちゅう飲む人。
サケビ	わめくこと。こわい目にあったり、おどろいたときにあげる大きな声。
サケメ	裂けたところ。
サコク	国が他国との通商・交通などを禁止、または強く制限すること。
ササ	丈の低い竹の総称。
ササエ	支えること。支えるもの。
ササゲモノ	神仏にささげる供え物。
サザエ	巻き貝の一種。つぼ焼きは有名。○○○さんは、有名な漫画。
サシイレ	外部から食べ物・衣類・日用品などを届けること。
サシエ	新聞・雑誌・書籍などの文中に差し入れる、その内容に関係のある絵。
サシガネ	直角に曲がった金属製の物差し。陰で指図して人をあやつること。
サシキズ	とがったもので突き刺した傷。
サシズ	人に言い聞かせて、あることをさせること。
サシミ	新鮮な魚介類などを生のまま薄く切り、薬味を添えた醤油などをつけて食べる料理。つくり。
サジ	液体や粉をすくい取る道具。スプーン。
サセツ	左へ曲がること。
サソイ	何かをするように勧めること。勧誘。
サダメ	決められたこと。決まり。運命。
サチ	さいわい。幸福。
サツエイ	カメラなどの機器を使って、物体の像を記録すること。
サツカ	小説や童話などを作る人。
サツカク	事実はそうではないのに、そうであるかのように、見まちがい、聞きまちがい、思いちがいをすること。
サツカー	十一人ずつの二組に分かれ、相手のゴールにボールをけり入れて得点を競う競技。
サツキ	つい先ほど。少し前。
サツキヨク	音楽の曲を作ること。
サツキン	熱や薬品などを用いて、細菌・病原菌などを死滅させること。
サツシン	これまでの事態を改めて、すっかり新しくすること。
サツタバ	紙幣を重ねて束ねたもの。多額のお金。
サツトウ	多くの人や物が一度に押し寄せること。
サツマイモ	ヒルガオ科の多年生植物。スイートポテト。カンショ。
サテイ	調査をして評価を決めること。
サト	田舎。生まれ育ったところ。「○○帰り」
サトイモ	球茎を食用とする多年草。ハスイモ。にころばしや、きぬかつぎの材料。
サトウ	菓子・料理などに多く使われる甘味料。シュガー。
サトウキビ	茎のしぼり汁から砂糖が取れる、常緑多年草。
サトオヤ	他人の子供を預かり、親代わりになって育てる人。
サトガエリ	実家に帰ること。
サトリ	仏教で心の迷いを去って永遠の真理を会得すること。
サドウ	お茶の道。
サドル	自転車・オートバイなどの、腰をかける台。
サナギ	昆虫が幼虫期を過ぎて成虫になる前のじっとしている姿。
サノウ	大脳の左半分。言語・文字などの情報処理を行っているとされる。
サバ	海の食用魚。背中は青緑色で不規則な波状紋がある。腹は銀白色。
サバク	乾燥した気候のため、草木がほとんど育たない、砂や岩ばかりの広い土地。
サビ	金属が空気や水にふれて、その表面にできる酸化物。
サホウ	動作や儀式をする上での決まった正しいやり方。
サボテン	砂漠や草原に生えるとげとげの植物。
サマー	英語で夏のこと。
サムケ	ぞっとした寒さ。
サムライ	むかし武芸を持って仕えた人。武士。
サメ	海の凶暴な生き物。皮膚はざらざら。ヒレは中華料理の材料。
サメハダ	サメの皮のように、乾燥してざらざらした肌。
サヤ	まめをおおっている外側の細長いから。刀をおさめ、おおっておく入れ物。
サユウ	左と右。
サヨウ	ある力がはたらいてほかの物に力をおよぼすこと。または、そのはたらき。
サヨウテン	てこで加えた力が物に対してはたらくところ。
サヨウナラ	別れるときに言うあいさつの言葉。
サラ	食べ物を盛る、浅くて平たい容器。
サラダ	生野菜などをいろいろ混ぜて、ドレッシングやマヨネーズであえた食べ物。
サラチ	手を入れていない土地。空き地。
サラリー	給料。月給。
サル	人間に一番近く、顔・手足以外は毛でおおわれ、顔やしりの赤い動物。
サン	みっつ。
サンカ	もよおし、会などに加わること。
サンカク	三角形のような形。
サンカクス	河水の運んできた土砂が河口付近に堆積してできた扇形の砂地。デルタ。
サンガツ	一年で三番目の月。
サンキヤク	三本の足。カメラ・望遠鏡・カンバスなどを乗せる。
サンギイン	衆議院とともに国会を構成する一院。
サンギヨウ	人の手で育てたり、作り出したりする仕事をまとめて言う言葉。
サングラス	色のついた眼鏡。
サンケツ	酸素不足になること。
サンケン	立法権・司法権・行政権の三つの国家統治権。
サンコウ	自分の考えを決めるときに他の人の考えや物事などを、考えの助けにする。
サンサイ	山野に自生する植物のうち、食用となるもの。
サンシヨウ	照らし合わせること。比較して参考にすること。
サンシン	野球・ソフトボールで、打者がストライクを三つとられてアウトになること。
サンスイ	水をまくこと。
サンスウ	数や図形などを勉強する小学校の科目の一つ。
サンセイ	考えが同じであると認め、支持すること。
サンソ	物が燃えたり、生物が生きていくために必要な気体。
サンゾク	山中に根拠地をかまえ、旅人などを襲う盗賊。
サンチ	ある物品が産出される土地。生産地。
サンチユウ	山の中。
サンテイ	計算してはっきりした数値を決めること。
サンデー	英語で日曜日のこと。
サンドウ	山の中の道。やまみち。
サンニユウ	新たに参加すること。
サンパイ	神社や寺へ行って拝むこと。
サンパツ	かみの毛を切って整えること。理髪。
サンビ	ほめたたえること。
サンブツ	その土地・国などで作り出されたり、とれたりする物。
サンプル	商品の見本や標本のこと。
サンポ	とくに目的もなく、ぶらぶら歩くこと。
サンマ	体が細長く、口先がとがっている秋の魚。
サンマイ	一枚の三倍。
サンマイメ	演劇・映画などでこっけいな役。また、それを演じる俳優。こっけいな人。
サンミ	すっぱい味。
サンミヤク	細長く連なった多くの高い山々。
サンラン	卵を産むこと。
サンリン	山と林。山中の林。
サンレツ	式・行事などに参加すること。列席。
サーカス	動物や人間の曲芸を見せてお金を取る見せ物。
サークル	円。円形。趣味を同じくする人の集まり。
サービス	人をもてなすこと。客のあつかい。他人のためにはたらいたり、つくすこと。
サーモン	英語で鮭のこと。
ザイカイ	大企業の実業家などが構成する社会。経済界。
ザイゲン	必要な金銭の出どころ。
ザイコ	品物が倉庫にあること。倉庫に入っている品物。ストック。
ザイサン	個人や会社などが持っている土地や建物、品物、お金などの値打ちのあるもの。
ザイシツ	材料の性質。
ザイシヨク	その職についていること。
ザイス	和室ですわって背をもたせ掛けるのに使う、脚のない椅子。
ザイセイ	国や自治体が収入を得、その管理・支出を行う経済行為。
ザイニチ	外国人が日本に滞在、または居住していること。
ザイバツ	財界に勢力のある大資本家、大資本家の一族一門。
ザイホウ	財物と宝物。
ザイモク	家や道具などを作るときに材料にする木。木材。
ザイリヨウ	物を作るもととなる物。
ザクギリ	野菜などをざくざくと大まかに切ること。
ザコウ	上体をのばしていすに座ったときの、座面から頭頂までの高さ。
ザコツ	骨盤の下半部を占める左右一対の骨。
ザコネ	大勢が入り混じって雑然と寝ること。
ザシキ	たたみを敷いた場所や部屋。
ザセキ	建物や乗り物の中の座る場所。席。
ザゼン	禅宗で行う修行。禅。背を伸ばして静かに座り、無我の境地を求める。
ザツガク	広い分野にわたる、まとまりのない知識や学問。
ザツコク	米・麦以外の穀類。
ザツシ	いろいろな内容をもりこみ、定期的に発行される本。
ザツシユ	異なった種類の雌雄の間に生まれた個体。
ザツシヨク	動物が動物性と植物性の食物を両方食べること。
ザツソウ	自然に生えてくる雑多な草。
ザツダン	とりとめなく、気軽にやりとりする話。
ザツヨウ	こまごまとした用事。
ザヒヨウ	点の位置を表す、数値の組。
ザブトン	すわるときに下に敷くふとん。
ザラメ	結晶のあらい、ざらざらした砂糖。
ザル	細長く、そいだ竹などを編んで作った底の浅い容器。
ザンギヨウ	規定の労働時間以後も残って仕事をすること。
ザンコク	やり方があまりにひどいさま。むごたらしい様子。
ザンシヨ	立秋を過ぎてもなお残っている暑さ。
シアイ	スポーツなどでおたがいにわざや力を比べ、勝ち負けを争うこと。
シアゲ	仕事の最後の手入れ。
シアサツテ	あさっての次の日。
シアター	劇場。映画館。
シアツ	手の指や手のひらで人体の局部を押して血行を盛んにする療法。
シアワセ	幸運に恵まれて、心が満ち足りていること。幸福。
シイク	家畜などにえさをあたえ、育てること。
シイタケ	ナラ、クリなどの枯れ木に生える食用きのこ。外面は褐色。肉は白色。
シイレ	販売・加工のために、商品や原材料を買い入れること。
シウンテン	乗り物や機械などの調子をみるために、ためしに運転すること。
シエア	ある企業の製品の売上高が市場全体の売上高に占める割合。市場占有率。
シエイ	市が運営すること。
シエフ	料理長。コック長。
シエン	力を貸して助けること。
シオ	海水や地中からとれる白くてからい物。
シオカゲン	塩味をつけるときの、塩の量。
シオカゼ	海から吹いてくる潮気をふくんだ風。
シオカラ	魚介類の肉・内臓・卵などを塩漬けにして発酵させた食べ物。
シオクリ	生活を助けるために金品を送ること。また、その金品。
シオヅケ	食べ物に塩を振りかけてつけ込むこと。
シオドキ	潮が満ちるとき。あることをするのにちょうどよい時期。
シオヒガリ	潮の引いた浜に出て貝などをとって遊ぶこと。
シオミズ	塩をふくんだ水。
シオモミ	塩をふりかけてもむこと。
シオヤキ	塩をふって焼くこと。
シオリ	本などに目印としてはさむ物。
シカ	ほっそりした体の哺乳類。オスは角が生える。尾は短い。
シカイ	会や式などがうまくいくように、進行を受け持つこと。または、それをする人。
シカク	四角形、または立方体や直方体のような形。
シカケ	からくりや仕組み。
シカタ	どのようにするかの方法。
シガイセン	目に見えない光線で、日焼けの原因。化学作用がある。ＵＶ。
シガツ	一年で四番目の月。
シキ	計算の順序や関係・法則などを記号や数字で表したもの。
シキイ	出入り口や部屋の仕切りの下にわたす、みぞのある横木。
シキキン	賃貸住宅などで、賃料の担保として借主から預かる保証金。
シキサイ	色。いろどり。
シキシヤ	見識のある人。有識者。
シキジヨウ	儀式を行う場所。
シキソ	物体が色を発するもとになる物質。
シキチ	建築物・道路などに使う一定区画の土地。
シキテン	一定の形式に従って行う大がかりな儀式。
シキベツ	物事の性質や種類などを見分けること。
シキモノ	物の下に敷く物。床の上に敷く物。
シキユウ	非常に急ぐこと。
シキヨウ	市場で商品・株式などが取引される状況。
シキリ	区切ること。区切った境界。
シキンセキ	金などの貴金属の鑑定に用いる黒色の硬い石。
シギ	「市議会議員」の略。
シクミ	からくり。組み立てられている物の構造。組み立て。
シグサ	ある物事をするときの態度ややり方。動作。
シケ	風雨のために海が荒れること。海が荒れて魚がとれないこと。
シケツ	出血を止めること。
シケン	人の能力や学力を調べるために、問題を出して答えさせること。
シケンカン	受験者に対面して試験を行う人。また、試験の監督にあたる人。
シゲキ	外から人の体に、ある種の強い感じをあたえること。
シゲミ	草や低木の生い茂っている場所。
シゲン	何かを生産するときのもとになるもの。
シコウ	直感・経験・知識などをもとに、あれこれと思いめぐらすこと。
シコナ	大相撲の力士の呼び名。
シコリ	筋肉などにできるかたまり。
シゴト	はたらくこと。決まった職業。
シサク	ためしに作ってみること。「○○○品」
シサツ	現地や現場に行って、実際の状況を見きわめること。
シサン	個人または法人が所有する、土地・家屋・金銭などの財産。
シザイ	物を作る材料とする物資。「建築○○○」
シシツ	生まれつきもっている性質や才能。
シシマイ	獅子頭（ししがしら）をかぶって行う舞。新年の祝いや祭礼に舞われる。
シシユウ	布地にいろいろな糸を使って絵や模様を縫い表すこと。
シシユツ	お金を払うこと。払うお金の額。
シシヨク	味をみるために、ためしに食べてみること。
シシンケイ	眼球の網膜が受けた刺激を大脳に伝える神経。
シジ	他人の意見や行動に賛成し、後おしすること。
シジツ	歴史上の事実。
シジヨウ	売り手と買い手が集まって商品や株式の取引を行う特定の場所。
シジン	詩を作る人。
シスウ	ある数字・文字の右上に小さく記し、それを何回掛け合わせるかを示す数字や文字。べき。
システム	体系。秩序・系統だった組織・制度。
シズク	したたり落ちる水や液体が粒状になったもの、
シセイ	体の構え方。態度。心の持ち方。
シセイカツ	個人としての生活。
シセキ	歴史に残る事件や建造物などがあった場所。
シセツ	養護・介護などの社会福祉事業を行うところ。
シセン	目で物を見ている方向。
シゼン	人間が手を加えない、ありのままのありさま。
シゼンスウ	一、二、三、四…のように、一から順に一つずつ増して得られる数。正の整数。
シソ	葉は梅干の着色に使われる、大変香りのいい一年草。
シソウ	人生・社会・政治などに対する一定の考え。
シソン	ある人から続いて生まれてきた、血筋のつながっている人々。
シタ	動物の口の中にある器官で、食べ物の味を感じ取れるもの。
シタウケ	ある人が請け負った仕事の全部または一部を、さらに請け負うこと。
シタウチ	舌で上あごをはじいて音を立てること。
シタギ	上着の下に着る衣服。特に、肌に直接つける衣服。肌着。
シタク	ある物事を行うために必要なものを準備し、整えること。
シタザワリ	食べ物などが舌にふれたときの感じ。
シタシミ	親しく思う気持ち。
シダ	ワラビ・ゼンマイなどの、葉は羽状で、胞子で増える植物。「○○植物」
シダイ	現在に至るまでの事情。いきさつ。なりゆき。
シダシ	注文に応じて料理を作って届けること。
シダレ	枝や葉が垂れ下がっていること。しだり。
シチ	七つ。
シチガツ	一年で七番目の月。
シチヤ	品物を預かって、代わりにお金を貸す店。
シチヤク	体に合うかどうか、ためしに着てみること。
シチユウ	物を支える柱。つっかいぼう。
シチヨウ	市の長。市を代表し、市政を統括する執行機関の長。
シツオン	室内の温度。
シツキ	うるしを塗って仕上げた器。
シツキヤク	それまでの地位や立場を失うこと。
シツギ	疑問の点を問いただすこと。口頭で説明を求めること。
シツギヨウ	それまでついていた職を失うこと。働く意思を持ちながら職につけないこと。
シツケ	しめりけ。
シツコウ	効力を失うこと。
シツシン	意識を失うこと。気絶。
シツソ	かざりけのないこと。つつましいこと。
シツソク	飛行中の航空機が急速に速度を失うこと。
シツチ	湿り気が多く、じめじめした土地。
シツド	空気中にふくまれている水蒸気の割合。
シツナイ	部屋の中。建物の内部。
シツパイ	物事をしくじる。やりそこなうこと。
シツピツ	文章を書くこと。
シツプ	炎症などを起こした患部に湯・冷水・薬液などに浸した布を当てること。
シツプウ	速く吹く風。
シツポ	動物の尾。
シツモン	わからないことや、もっと知りたいことをたずねること。
シツリヨウ	物体に備わっている固有の量。これが大きいほど、働く重力が大きい。
シテイ	師と弟子。先生と生徒。「○○○関係」
シテキ	見つけ出して指し示すこと。まちがいなどを取り立てて言うこと。
シテン	物を見たり考えたりするときの目のつけどころ。
シト	使いみち。「○○不明金」
シドウ	知識・技術などを習得できるように教え導くこと。
シナ	売っている物。商品。
シナイ	剣道で使う竹製の刀。
シナウス	需要に対して品物が不足していること。
シナカズ	品物の数。
シナギレ	品物が売り切れること。
シナリオ	映画・テレビドラマなどの脚本。台本。
シナン	きわめて難しいこと。「○○○のわざ」
シニセ	何代も同じ商売を続けてきた、格式と信用がある店。ろうほ。
シハライ	支払うこと。
シハン	一般の小売店で売られていること。
シバ	空き地などに生える、葉の細い草。
シバカリ	伸びた芝を刈りそろえること。
シバフ	一面に芝の生えているところ。芝を植えてあるところ。
シフク	制服ではない、個人の服。
シブ	渋い味。渋み。「○○柿」
シブガキ	熟しても渋みの抜けない柿。
シブキ	細かい粒になって勢いよく飛び散る水。
シブツ	個人の所有物。
シブミ	渋い味。深みのあるおもむき。
シブンシヨ	法律で、公務員以外の者が作成した文書。
シヘイ	紙でできたお金。お札。
シホウ	国家が法に基づいて裁判に関して行う一切の作用。民事および刑事の裁判。
シホウケン	国家の統治権のうち、司法作用を行う権能。
シホン	事業や商売をするときの元手となるお金。
シホンカ	自分の所有する資本を投下し、企業を経営して利潤を上げる人。
シホンキン	事業を運営するときの基礎となる資金。
シマ	周りを海や湖にすっかり囲まれている陸地。
シマイ	姉と妹。
シマウマ	しましまのある馬。ゼブラ。
シマグニ	周囲を海で囲まれている国。
シミ	液などが部分的にしみついて汚れたところ。
シミズ	地中や岩間からわき出る、清らかにすんだ水。
シミン	市に住んでいる人。都市の住民。
シメイ	苗字と名前。姓名。
シメキリ	取りあつかいを終わりにすること。
シメリケ	水分をわずかに含んでいる感じ。しっけ。
シメンソカ	四方を敵に囲まれて孤立無援であること。
シモ	晴れた寒い夜、水蒸気が地面に白くこおり付いた物。
シモバシラ	冬、地表にできる細い氷の柱の集まり。
シモフリ	赤身の中に脂肪が細かい網のように入り組んでいる牛肉。
シモヤケ	寒さのために皮膚の欠陥が麻痺して起こる軽度の凍傷。
シモン	人の指先の内側にある、たくさんの細い筋で出来ている模様。
シヤ	目を動かさないで見ることのできる範囲。
シヤイン	会社に勤めている人。
シヤカ	仏教の開祖。「○○○に説法」
シヤカイ	たがいに助け合って生活している人々の集まり。
シヤカイカ	社会生活に関する基本的な知識を学習し、社会人として必要な資質を身につけるための教科。
シヤキヨウ	経文を書き写すこと。
シヤクシヨ	市の職員が事務をする役所。
シヤクハチ	竹の根元に近い部分で作った縦笛。
シヤクメイ	非難・誤解などに対し、相手の理解を求めるために自分の考えや事情を説明すること。
シヤクヨウ	使用するために金銭・物品などを借りること。
シヤケン	自動車の定期的な車体検査。
シヤコ	電車・自動車などの車両を入れておく建物や場所。
シヤコウ	人と人とのつきあい。社会での交際。「○○○○的」
シヤサイ	株式会社が一般から資金を調達するために発行する債券。
シヤシユ	自動車を動力・用途・型などによって分けた種類。
シヤシヨウ	電車・バスなどに乗務して、旅客・荷物などに関するサービスや事務を行う職員。
シヤシン	実際の様子をカメラで写すこと。または、写して記録された物。
シヤシンキ	写真を撮影するための光学機械。カメラ。
シヤジツ	物事をありのままに描写すること。
シヤセイ	自然や物事を目に映るとおり、ありのままに絵や文章にかくこと。
シヤセン	ななめになっている線。
シヤタイ	車両で人や荷物を積載する部分。また、車両の外形全体。ボディー。
シヤタク	社員やその家族を住まわせるために、会社が所有・管理する住宅。
シヤダンキ	踏切などで、電車の通過時に道路を閉鎖し、人や車両の通行を止める装置。
シヤチ	イルカの仲間。するどい歯を持つ。クジラ、アザラシ、サメなどをおそって食べる。
シヤチヨウ	会社で一番上の役目の人。会社の代表者。
シヤツ	上半身に着る西洋風の肌着。
シヤツクリ	横隔膜がけいれんして急に空気を吸いこむときの音。
シヤナイ	会社の建物の内部。また、会社の組織の内部。
シヤミセン	邦楽の演奏に使う三弦の弦楽器。
シヤメイ	神社・会社・結社などの名称。
シヤメン	かたむいている面。
シヤモジ	飯や汁をすくう柄のついた道具。
シヤリン	車の輪。
シヤワー	水や湯を雨のように注ぎかける装置。また、その水や湯。
シユウ	日曜から土曜までの七日間を単位として区切った期間。
シユウイ	周りを取り巻いているもの。
シユウエキ	もうけたお金。
シユウカ	各地から農水産物などの荷が集まること。また、荷を集めること。
シユウカイ	同じ目的のために人が集まること。
シユウカク	作物をとり入れること。何かを行って得た、よいもの。
シユウカン	長い間行われていて、決まりのようになった行動。ならわし。
シユウガク	学校に入って教育を受けること。
シユウキン	お金を集めること。
シユウケイ	数を寄せ集めて合計すること。
シユウケツ	一か所に集まること。また、集めること。
シユウゴウ	一つのところに集まること。
シユウサイ	学問・才能が人並み以上にすぐれた人。
シユウサク	すぐれた作品。
シユウシ	収入と支出。
シユウシフ	欧文で、文の終わりにつける符号。ピリオド。
シユウジ	文字を正しく、美しく書くための練習。
シユウセイ	間違いを直して正すこと。
シユウセン	戦争が終わること。
シユウゼン	こわれたり、いたんだりした物を直して使えるようにすること。
シユウソク	やむこと。終わること。
シユウダン	人々のまとまり。
シユウチ	私人、または私的団体が所有している土地。
シユウテン	物事の最後になる所。乗り物が最後に付く駅。
シユウトク	落とし物を拾うこと。「○○○○○物」
シユウトメ	配偶者の母親。
シユウハ	同じ宗教の中の分派。
シユウハイ	郵便物・貨物などを集めることと配ること。
シユウフク	壊れたものを元通りに直すこと。
シユウヘン	その辺り一帯。周囲。付近。
シユウマツ	一週間の終わり。
シユウヨウ	人や物を一定の場所や施設におさめ入れること。
シユウラク	人家が集まっている所。村落。
シユウリ	壊れたものを直して仕えるようにすること。修繕。
シユウロク	放送する内容を録音・録画すること。作品や情報を内容として収めること。
シユエン	映画・演劇などで主役を演じること。また、その人。
シユガー	英語で砂糖のこと。
シユギ	その人がいつも持っている、行動するときの考え方や立場。
シユギヨウ	仏教で悟りを開くために、戒律を守って仏道にはげむこと。
シユクジツ	祝いごとのある日。特に国が定めた祝いの日。
シユクダイ	家で勉強するように先生があたえる問題。解決できないで残された問題。
シユクテキ	ずっと以前からの敵。
シユクハク	旅先などで泊まること。
シユクフク	幸福を祝うこと。また、幸福を祈ること。
シユケン	国民および領土を統治する最高の権力。統治権または国権。「○○○○在民」
シユゲイ	編み物・刺繍（ししゅう）など、手先を使ってする技芸。
シユゴ	文の中で「何が」「何は」に当たる部分。
シユサイ	会などを中心になって計画し、開くこと。
シユザイ	新聞や雑誌などの記事を書くための材料を集めること。
シユシヨウ	内閣総理大臣の普通の呼び方。
シユジユツ	体の悪いところを外科的に直す方法。
シユジン	その家の代表。あるじ。その店の一番上の人。
シユダイ	作品・議論・研究などの中心となる題材や思想。テーマ。
シユダン	目的を達するための方法、やり方。
シユチヨウ	自分の意見・説を認めてもらえるよう、強く言うこと。また、その意見・説。
シユツエン	舞台・映画・放送番組などに出て芸などを演じること。
シユツガン	願書を出すこと。官公庁などに認可・許可を願い出ること。
シユツキン	勤め先に出かけること。また、勤めに出ていること。
シユツケ	世俗の生活を捨てて仏門に入ること。
シユツケツ	血液が血管の外に流れ出ること。
シユツゲン	現れ出ること。
シユツコウ	船が航海に出ること。航空機が出発すること。
シユツサン	子が生まれること。また、子を産むこと。
シユツシ	資金を出すこと。また、資本を出すこと。
シユツシン	その土地の生まれであること。また、その学校・団体などの出であること。
シユツセ	世の中に出て成功し、立派な地位や身分を得ること。
シユツセキ	授業や集会、儀式などに出ること。
シユツダイ	試験・クイズなどの問題を出すこと。
シユツテイ	裁判のために法廷に出ること。
シユツパツ	出かけること。
シユツパン	雑誌・本などを印刷して発行すること。
シユツピン	展覧会・展示会などに作品や物品を出すこと。
シユツボツ	現れたり隠れたりすること。姿をあらわしたり、いなくなったりすること。
シユト	その国の政府があって、政治や経済の中心となる都市。
シユトク	一定の手続きを経て、資格・権利・物品などを自分のものにすること。
シユトケン	東京都とその周辺を含む地域。
シユドウ	中心になって導くこと。
シユニク	朱色の印肉。
シユヒギム	業務上知ることのできた秘密を守らなくてはならない義務。
シユビ	敵の攻撃を防いで味方の陣地を守ること。
シユフ	すいじ・洗濯・そうじなどの家事をおもにする妻。
シユミ	自分の興味・楽しみ・好みですること。上品なおもむき。
シユヤク	映画・演劇などで、主人公の役。また、それを演じる役者。
シユヨク	飛行機に揚力を与える、もっとも大きな翼。
シユリユウ	中心となる流れ。中心となっている傾向。
シユルイ	たくさんの物の中で、同じような形・性質を持つ物のまとまり。
シユワ	手・指の動きや身振りによる意思の伝達方法。
シユン	野菜・果物・魚介類などの、出盛りで最も味のよい時期。
シユンカン	非常に短い時間。またたく間。一瞬。
シヨ	書かれた文字。書いてまとめた物。書物。
シヨウ	物や人を使うこと。用いること。
シヨウアク	物事を自分の意のままに動かせるようにすること。
シヨウイン	勝利を得た原因。
シヨウカ	食べた物を、栄養分として体に取り入れることができる状態に変えるはたらき。
シヨウカイ	知らない人同士を間にたって引き合わせること。
シヨウカキ	初期火災の消火に用いる小型の器具。
シヨウガ	辛みと香りの強い、黄白色の根茎。食用や薬用にする。ジンジャー。
シヨウガイ	けがをさせること。けが。
シヨウガク	小さい金額。
シヨウガツ	一年の最初の月。一月。
シヨウキチ	おみくじや占いなどで、運勢・縁起がややよいこと。
シヨウキン	賞として与える金銭。くじなどに当たった人に与える金銭。
シヨウギ	王将、金将、銀将などのこまをたがいに動かして、相手の王将を動かせないようにする遊び。
シヨウケイ	全体の中の一部分を合計すること。また、その合計。
シヨウゲキ	はげしい打撃を受けること。はげしく心が動かされること。
シヨウコ	それが間違いではないという印。
シヨウゴ	太陽が子午線を通過する時刻。昼の十二時。
シヨウゴウ	呼び名。特に、身分・資格などを表す呼び名。
シヨウサイ	細かい点まで詳しいこと。
シヨウサン	ほめたたえること。
シヨウシカ	子供の出生率・出生数が減少すること。
シヨウシヤ	戦い・試合・競争などに勝った人。勝利者。
シヨウジ	木の枠に白い和紙などを張った建具で、部屋を仕切るもの。
シヨウジキ	うそを言ったりしないさま。
シヨウジヨ	年の若い女の子。
シヨウスウ	数が少ないこと。
シヨウセツ	作者が、自分の作り出した人物や筋を通して、人生の真実などをえがこうとする文学作品。
シヨウソ	訴訟に勝つこと。
シヨウゾウ	ある人の顔や姿を絵・写真・彫刻などに写した像。
シヨウタイ	そのものの本当の姿。
シヨウダク	相手の依頼・要求などを了解して、受け入れること。
シヨウダン	商売についての話し合い。商取引の相談。
シヨウチ	要求などを聞き入れること。事情を前もって知っていること。許すこと。
シヨウテン	レンズや鏡などで、反射したり、反射したりした光線が一点に集まるところ。
シヨウトウ	あかりを消すこと。
シヨウトツ	物と物がぶつかること。突き当たること。
シヨウドク	感染を予防するため、薬品・高熱・紫外線などによって病原菌を殺すこと。
シヨウニカ	子供の内科的な病気を専門に扱う医学の一分野。
シヨウニン	よいと認めること。正しいと認めて許すこと。聞き入れること。
シヨウネン	年の若い男の子。
シヨウハイ	勝つことと負けること。勝ち負け。
シヨウバイ	もうけを生むように、物を売ったり買ったりすること。
シヨウヒ	お金や品物、時間などを使って、なくすこと。
シヨウヒン	売ったり買ったりするための品物。
シヨウブ	勝ち負け。勝敗。
シヨウボウ	火事を消し、延焼を防ぎ、また火災の発生を防ぐこと。「○○○○○車」
シヨウメイ	明るく照らし出すこと。または、その明かり。
シヨウモウ	使ってなくなること。体力・気力などを使い果たすこと。「○○○○○戦」
シヨウユ	小麦と大豆を原料として作った麹（こうじ）に食塩水を発酵させてしぼった黒茶色の液体。わが国特産の調味料の一つ。
シヨウヨ	官庁や会社で、給与以外に支給する金銭。ボーナス。
シヨウライ	これからやってくる時。これから先。未来。
シヨウリ	戦いや試合などに勝つこと。
シヨウリツ	試合などに勝った割合。
シヨウワ	平成の一つ前の年号。
シヨカ	夏の初め。
シヨキ	物事のはじめの時期。はじまって間もないころ。
シヨク	職業。仕事。
シヨクアン	「職業安定所」の略。
シヨクイン	会社や役所・学校などで、事務をおこなっている人。
シヨクエン	食用として精製した塩。
シヨクゴ	食事を済ませた後。
シヨクジ	ご飯を食べること。または、食べる物。
シヨクタク	食事をするときに用いる台。
シヨクツウ	食べ物の味や知識によく通じていること。グルメ。
シヨクドウ	食事をするための部屋や店。
シヨクニン	熟練した技術によって物を作ることを職業とする人。
シヨクバ	会社・工場などに勤めている人が作業や職務を行う場所。勤務する所。
シヨクパン	特別の味付けをしないで箱型に焼いたパン。
シヨクヒ	食事のために必要な費用。
シヨクヒン	食べられる品物。
シヨクブツ	木や草などをまとめて言う言葉。
シヨクヨウ	食べ物として用いること。
シヨクヨク	食べ物を食べたいという欲望。食い気。
シヨクリン	森林にするために木を植えること。
シヨクレキ	職業についての経歴。
シヨサイ	個人の家で、読書・執筆などをする部屋。書室。
シヨザイ	物・人・責任などがある所。
シヨジ	身につけて持っていること。「○○○品」
シヨセキ	書物。本。図書。
シヨタイ	文字を書いたり、印刷するときの字や活字の形のタイプ。フォント。
シヨダイ	ある系統の最初の代。
シヨチ	物事の始末をつけること。取り計らうこと。処理。手当てをすること。
シヨチユウ	夏の暑い間。
シヨチヨウ	警察署・消防署・税務署などの署と名のつく役所の長。
シヨツカク	昆虫やエビなどの頭にあるひげのようなもの。
シヨツキ	食事に用いる容器・器具。
シヨツク	英語で衝撃のこと。
シヨテン	書物を売る店。本屋。
シヨトウ	冬のはじめ。はつふゆ。
シヨトク	一定期間中にはたらいて得る収入。
シヨドウ	文字を毛筆で正しく美しく書くわざ。
シヨニチ	何日か続く興行・催し物などの最初の日。
シヨホ	学問・技芸などで、習い始めの段階・程度。
シヨミン	権力者や資産家などではない、世間一般の人々。一般大衆。
シヨメイ	文書などに自分の氏名を書き記すこと。
シヨモツ	本。書籍。
シヨユウ	持っていること。
シヨリ	物事をかたづけること。
シヨルイ	必要な事がらを書いてある文書。
シヨー	歌やおどり、展示会などのもよおしもの。
シラガ	白くなった毛髪。
シラガゾメ	白髪を黒く染めること。また、その薬剤。
シラコ	雄の魚の腹にある乳白色の精巣。
シラセ	知らせること。また、その内容。
シラタマコ	もち米の粉を水でさらし、精製・乾燥させたもの。
シラハタ	白色の旗。しろはた。
シラベ	音楽の調子。調べること。
シリヨウ	物事を調べたり、研究したりするときの参考になる材料。データ。
シリヨク	目の、物を見分ける力。
シルク	絹。絹糸。「○○○ロード」
シルシ	他と区別したり、他に合図するための記号や図形。目印。マーク。
シルバー	銀。銀色。高齢者。
シレツ	勢いが盛んで激しいこと。
シロ	雪のような色。罪のうたがいがないこと。
シロアト	昔、城があった場所。
シロウト	そのことを専門の仕事にしていない人。
シロクマ	白い熊。ホッキョクグマ。
シロザトウ	精製した白色の砂糖。
シロツプ	砂糖・水あめなどを煮溶かして作る濃厚な液。
シロバイ	交通取締りの警察官が使用する白塗りのオートバイ。
シロミ	卵の黄身を包む透明な部分。卵白。
シロメ	眼球の白い部分。
シワ	ひふ・布などの表面がゆるんだり、ちぢんだりしてできる細かい筋。
シワケ	品物・郵便物などを種類別・用途別などに分けること。
シンアイ	その人に親しみと愛情を持っていること。
シンイ	真の気持ち。本心。
シンイリ	ある集団などに仲間として新しく入ること。また、その人。
シンカ	生物が長い年月の間にだんだんと高等なものになっていくこと。
シンカイ	深い海。
シンカロン	生物は創造主によって創造されたものではなく、原始生命から現在の形態へと進化してきたという説。
シンガク	上級の学校に進むこと。
シンガタ	従来のものとは違う、新しく考案された型・形式。
シンガー	歌手。
シンキユウ	上の学年・等級に進むこと。
シンキヨウ	心の状態。気持ち。
シンキヨク	新しく作った歌曲・楽曲。
シンキロウ	水平線や地平線の向こうの景色が浮き上がって見えたりする光の異常屈折現象。
シンギ	提出された案などを詳しく調べ、その可否を決めるために討議すること。
シンクウ	空気などの気体がまったくない空間。空気を抜くこと。
シンケイ	脳からの指令を体の各部に伝えたり、体の各部からのしげきを脳に伝える、糸のような器官。
シンケン	本当の刀剣。心をこめて、本気でするさま。
シンゲン	目上の人に意見を申し述べること。
シンコウ	物事を順序よく進めること。
シンコク	事がらがせっぱつまって、たいへんなさま。
シンコン	結婚したばかり。
シンゴウ	道路や鉄道などで進行可・停止・注意の区別を示し、交通の規制をする標識。
シンサ	何らかの基準をもって物事を調べ、その優劣・等級・適否などを決めること。
シンサク	新しく作品などを作ること。また、その作品。
シンサツ	医者が患者の体を実際に調べ、病状や病気の原因などを判断すること。
シンシ	まじめでひたむきなこと。
シンシツ	寝るときに使う部屋。寝間。
シンシヤ	真新しい車。新型の車。
シンシユ	新しく発見された生物の種。改良などによって作られた品種。
シンシユク	伸びたり縮んだりすること。伸ばしたり縮めたりすること。
シンシユツ	新しい分野に進み出て活動の領域を広げること。
シンシヨク	水や風が長い時間のうちに、岩石や大地をけずり取っていくこと。
シンジ	神を祭る儀式。まつり。
シンジツ	うそやいつわりのない、本当のこと。まこと。
シンジユ	アコヤ貝にできる美しい玉の宝石。
シンジヨウ	心の中で感じていること。心中の思い。
シンセイ	国・公共団体などの機関に、許可・認可などを願い出ること。
シンセキ	血筋や結婚によって、縁のつながっている身内。親類。
シンセツ	思いやりの心が深いこと。真心がこもっているさま。
シンセン	たいへん新しくて、生き生きしているさま。
シンゼン	互いに知り合って、親しく付き合うこと。
シンソウ	ある事件などの本当の内容や事情。
シンソツ	その年に学校を卒業すること。あるいは卒業した人。
シンゾウ	左の胸の内部にある、体じゅうに血を送り出している器官。
シンタイ	人間の体。
シンダン	医者が患者を診察して患者の状態を判断すること。
シンチク	新しく建物を建てること。また、その建物。
シンチヤク	品物などが新たに到着すること。また、届いたばかりの物。
シンチヨウ	背の高さ。背丈。
シンテン	物事が進行して新しい局面が現れること。また、物事が進歩・発展すること。
シンデン	神を祭る殿堂。神社の本殿。
シントウ	日本固有の民族的信仰として伝承されてきた多神教の宗教。
シンド	ある場所での地震の強さの程度。
シンドウ	細かくゆれ動くこと。
シンニチ	外国人が日本に好意を持ち、親しくすること。
シンネン	新しい年。年の初め。
シンバル	打楽器の一つで、金属のうすい円い板で音を鳴らすもの。
シンパク	心臓の拍動。
シンパン	競技などで、勝ち負けの判定をすること。または、それを任せられている人。
シンピ	人間の知恵では計り知れない、不思議なこと。
シンピン	新しい品物。
シンブ	深い部分。奥深い所。
シンブツ	神と仏。神道と仏教。
シンブン	社会の出来事を早く正しく、多くの人に知らせるために、毎日、または日を決めて発行している印刷物。
シンプ	結婚したばかりの女性。花嫁。
シンボウ	車やこまなどの真ん中にある棒。
シンポ	だんだんと質が向上していくこと。
シンマイ	新しい米。
シンミツ	親しい関係、深い関係にあること。
シンメ	新しく出てきた芽。
シンヤ	真夜中。夜ふけ。
シンヤク	新しい薬。
シンユウ	きわめて親しい友。
シンライ	信じて頼りにすること。信用して任せること。
シンリ	心の働き。意識のありさま。「○○○学」
シンリヨウ	診察して治療すること。
シンリン	たくさんの木が集まって生えている場所。
シンロ	これから進んでいく方向や道筋。
シンロウ	結婚したばかりの男性。花婿。
シンワ	古代から伝承されてきた、神聖さを帯びた物語。「ギリシア○○○」
シージー	コンピューターを使用して画像や動画を作成・表示すること。また、その画像や動画。
シーズン	英語で季節や旬のこと。
シート	座席。席。
シーフード	魚介・海草など、海産食品の総称。
シール	裏にのりが付いたはり紙。
シーン	劇や映画などの一つ一つの場面。
ジイ	老年の男性。男性の老人。「○○さん」
ジエイ	他からの攻撃などに対し、自分の力で自分を守ること。
ジカ	その時々につけられた物の値段。
ジカイ	次の回。
ジカク	自分の立場や責任についてわきまえること。
ジカビ	料理などで、材料に直接火を当てること。また、その火。
ジカン	ある時から、ある時までの間の長さ。時の区切り。時の長さをはかる単位。
ジカンワリ	一日の仕事や授業の予定を割り当てること。または、その予定を書いた表。
ジガゾウ	自分で描いた自分の肖像。
ジキ	ある一定の期間。また、あることを行う時。
ジキヒツ	本人が直接筆をとって書くこと。また、書いたもの。
ジキユウ	働いた時間量に応じて支給する給料。時間給。
ジキヨク	磁石の両端の、鉄を引き付ける力の最も強いところ。
ジギヨウ	生産・営利などを目的として継続的に行われる経済活動。
ジク	車やこまなどの回転の中心となる心棒。
ジクアシ	軸として体を支える方の足。
ジケン	出来事。もめ事。
ジゲン	授業などを行う時間割の単位。
ジコク	時間の流れの中のある瞬間。
ジゴクミミ	人の秘密などをすばやく聞きつけること。きわめて耳がよく聞こえること。
ジサ	時間の差。標準時の違い。時間をずらすこと。
ジサク	自分で作ること。
ジサツ	自分で命を絶つこと。
ジシヤク	鉄などをひきつける性質をもつもの。
ジシユウ	次の週。
ジシユク	自分から進んで行動や態度をつつしむこと。
ジシヨ	言葉を集めて、一定の順序に配列し、発音・表記・意味・用法などを説明した本。辞典。字引。
ジシヨウ	自分から勝手に名乗ること。
ジシヨク	自分から職をやめること。
ジジツ	実際にあったこと。うそではないという気持ちを表す言葉。
ジジヨ	二番目に生まれた女の子。
ジジヨウ	物事のいろいろな様子や理由など。
ジジヨデン	自分で書いた自分の伝記。自伝。
ジスイ	自分で自分の食事を作ること。
ジスベリ	斜面となっている土地の表面がすべり落ちること。
ジゼン	物事が起こる前。物事が行われる前。
ジソク	一時間に進む距離で表す速さ。
ジゾク	ある状態がそのまま長く保たれること。また、保ち続けること。
ジタイ	物事の様子やなりゆき。
ジタク	自分の生活の拠点としている家。自分の家。
ジダイ	歴史のうえで、一定の基準によって区切った、かなり長い年月。
ジダイゲキ	江戸時代またはそれ以前の武家時代を題材とした演劇や映画。
ジチ	自分や自分たちに関することを自身の責任で処理すること。「地方○○体」
ジツイン	市区町村の役所などに登録されている印鑑。
ジツエン	公衆の前で実際にやってみせること。
ジツカ	自分の生まれた家。
ジツカン	実際に感じること。実際に見たり聞いたりしているそのままの感じ。
ジツギ	実地に行う技術・演技。
ジツケン	予想が正しかったか、正しくなかったか、試してみること。
ジツコウ	実際に行うこと。
ジツシ	予定されていたことを実際に行うこと。施行。
ジツシヤ	実際の情景や状況をビデオやフィルムなどに写し取ること。また、その映画や写真など。
ジツシユウ	技術・方法などを実地に学ぶこと。
ジツセキ	それまでに残してきた成績や功績。
ジツセン	実際の戦闘。実際の試合。
ジツチ	実際にそのことを行うこと。
ジツブツ	実際の物。
ジツム	実際に行う業務。具体的な仕事。
ジツメイ	本当の名前。本名。
ジツヨウ	実際に用いること。また、用いて役立てること。
ジツリヨク	実際に持っている能力。「○○○○行使」
ジツレイ	実際にあった例。
ジツワ	実際にあった話。
ジテンシヤ	乗り手が自分の足でペダルを踏み、その力で車輪を回転させて走る乗り物。
ジデン	自分で書いた自身の伝記。自叙伝。
ジドウ	子供。特に小学生のこと。
ジドウシヤ	エンジンの力で車輪を回転させて走る車の総称。
ジドリ	その土地の在来種として古くから飼われているニワトリ。また、その肉。
ジナン	二番目に生まれた男の子。
ジニン	職務や任務を自分から申し出てやめること。
ジヌシ	土地の所有者。
ジバラ	自分の持っているお金。また、自分のお金で支払うこと。
ジブン	その人自身。本人。
ジマク	映画やテレビで、題名・配役・説明などを文字で表したもの。
ジミ	はでではなく、ひかえめなさま。
ジミチ	地味な態度で手堅く着実に物事をすること。
ジム	会社・役所などで、主に机の上で書類の作成・整理などを行う仕事。
ジムシヨ	事務を取り扱う所。オフィス。
ジモト	その人の出身地。また、住んでいる地方。
ジヤガイモ	地下茎にでんぷんをたくわえていもになったもの。ばれいしょともいう。
ジヤグチ	水道管の先に取り付けて、水の量を調節する金属製の器具。
ジヤズ	アメリカの黒人音楽から発達したポピュラー音楽。
ジヤドウ	本筋から外れた、望ましくない方法。道徳から外れた、よこしまな道。
ジヤパン	英語で日本のこと。
ジヤム	果物に砂糖を加えて煮詰めた保存食品。
ジヤリ	細かい石の集まり。小石に砂の混じったもの。
ジヤングル	熱帯地方の森林。密林。
ジヤンケン	グー、チョキ、パーの形を出して勝ち負けを決める遊び。
ジヤンボ	「特大の」を意味する言葉。「○○○○ジェット機」
ジヤー	広い口をしたまほうびん。
ジユウ	自分の思うままに、したいようにできること。
ジユウイ	動物の病気やけがを治す医者。
ジユウオウ	たてとよこ。
ジユウガタ	競泳種目の一つで、泳法に制限のないもの。
ジユウガツ	一年で十番目の月。
ジユウキヨ	人が住んでいる場所・家。すみか。
ジユウケツ	体のある部分で血の流れが異常に増えること。また、その状態。
ジユウシ	大事なものとして重くみること。
ジユウシヨ	住まいのある場所。ある場所を表すもの。
ジユウジ	漢字の「十」の形。
ジユウジツ	内容・実質が豊かで、満ち足りていること。
ジユウセイ	銃を発射したときに起こる音。
ジユウゼイ	負担の重い税金。
ジユウソウ	炭酸水素ナトリウム。ふくらし粉。
ジユウタイ	車などがなめらかに進まないこと。
ジユウタク	人のすみか。住まい。
ジユウデン	電池に電気をたくわえること。
ジユウドウ	素手で組み合い、相手の力を利用して相手を投げたり、おしたり、おさえこんだりする武道の一種。
ジユウブン	物事が満ち足りて、何の不足もないさま。
ジユウマン	空間に気体などがいっぱいに満ちること。
ジユウミン	その土地に住んでいる人たち。
ジユウレツ	縦に並ぶこと。
ジユエキ	樹木に含まれている養分となる液。
ジユキユウ	需要と供給。
ジユギヨウ	学校などで先生が学問や技術を教えること。
ジユク	私設の、学問・技芸などを学ぶところ。
ジユクゴ	二字以上の漢字が結び付いて、一つの意味を表す言葉になったもの。
ジユクスイ	ぐっすり眠ること。熟眠。
ジユクセイ	発酵したものが十分に熟して独特な風味・うまみが生じること。
ジユクドク	文章の意味を考えてよく読むこと。
ジユクレン	十分に経験を積んで、巧みにできること。「○○○○○のわざ」
ジユケン	試験を受けること。
ジユシ	樹木から分泌される粘液。また、それが空気にふれて固まったもの。
ジユシヨウ	賞を受けること。
ジユシン	電信・電話・放送などを受けること。
ジユズ	たくさんの珠（たま）を糸に貫いて輪にしたもの。
ジユチユウ	注文を受けること。
ジユツ	身につけた特別のわざ。手段・方法。
ジユツゴ	文の中で何が「どうだ」「どんなだ」などを表す部分。
ジユニア	年少者。特に十代の少年少女。下級生。二世。
ジユニユウ	幼児に乳を飲ませること。
ジユヒヨウ	氷点以下に冷却した霧が冷えた木の枝などに凍りついたもの。
ジユヨ	さずけ与えること。
ジユヨウ	あるものを必要として求めること。
ジユリ	書類などを受け取って処理すること。
ジユリツ	物事がしっかりと定まること。また、しっかりと打ち立てること。
ジユレイ	樹木の年齢。
ジユワキ	電話機・無線機で、直接耳に当てて相手の話を聞く装置。レシーバー。
ジユンアイ	純粋な愛情。
ジユンイ	ある基準によって決めた順序の中の位置。
ジユンカン	物がある経路や変化をたどって、元に戻ること。また、それを繰り返すこと。
ジユンキン	混じり物のない金。24金。
ジユンシユ	法律・規則・教えなどに従い、それをよく守ること。
ジユンジヨ	一定の決まりにしたがった並べ方。
ジユンスイ	他の物が混じっていないさま。
ジユンセイ	純粋で正しいこと。混じりけがなくて本物であること。
ジユンド	純粋さの度合い。
ジユンノウ	環境・境遇・刺激などの変化に従って性質や行動が変わり、それに適応するようになること。
ジユンバン	決められた順に何かをすること。また、その順序。
ジユンパク	まじりけのない白色。また、まっ白であること。
ジユンビ	物事をすぐやれるよう、したくをすること。用意すること。
ジユンレイ	宗教上の目的から神社仏閣や聖地などを参詣して回ること。
ジユース	果物・野菜などをしぼった汁。また、それを加工した清涼飲料水。
ジヨイ	女性の医師。
ジヨウ	相手を思いやる心。異性を愛する気持ち。
ジヨウエイ	映画をスクリーンに映し出して観客に見せること。
ジヨウオン	ふつうの温度。
ジヨウカ	汚れを取りのぞき、きれいにすること。
ジヨウガイ	ある限られた場所の外。「○○○○○乱闘」
ジヨウキ	液体が温められてできる気体。
ジヨウギ	直線・曲線・角度などを書くとき、物を裁断するときにあてがう用具。
ジヨウクウ	空の上の方。
ジヨウケイ	人の心にある感情を起こさせる風景や場面。
ジヨウケン	ある事がらを成立させるために必要な事がら。
ジヨウゲ	上と下。上がり下がり。
ジヨウゴ	口の狭い容器に液体をそそぎ入れるときに使う用具。
ジヨウザイ	飲みやすくするために、一定の形に圧縮した固形の錠剤。タブレット。
ジヨウシキ	いっぱんの人がみんな持っている考えや知識。
ジヨウシツ	品質が上等であること。
ジヨウジ	いつも。普段。普通のとき。
ジヨウタイ	ある時点における人や物事のありさま。
ジヨウタツ	技芸・学術などが進んでうまくなること。
ジヨウデキ	できぐあいがよいこと。物事の結果がよいこと。
ジヨウト	権利・財産などを他人にゆずりわたすこと。
ジヨウナイ	会場の内部。ある限られた場所の中。
ジヨウネツ	激しく燃え上がる感情。熱情。
ジヨウハツ	液体が気体になること。消えたようにどこかに逃げてしまうこと。
ジヨウバ	馬に乗ること。
ジヨウヒン	気品があるさま。洗練されているさま。
ジヨウホ	自分の主張をひっこめて相手の主張を受け入れること。
ジヨウホウ	ある事柄の内容や事件などについての知らせ。文字・音声などの媒体によって伝達される知識や資料。
ジヨウム	社長や専務取締役を補佐し、日常の経営業務を執行する役職。
ジヨウモン	土器の表面に縄などを押し付けて施した文様。
ジヨウヤク	国際上の権利・義務に関し、国家間または国家と国際機関間で結ばれる文書による合意。また、その文書。
ジヨウヨ	割り算で割り切れずに残った数。余り。
ジヨウヨウ	ふだん使っていること。
ジヨウリク	船や海から陸に上がること。台風が陸地をおそうこと。
ジヨウレン	飲食店などにいつも来る客。いつも一緒に行動する仲間。
ジヨウロ	草花・植木などに水をやるのに使う園芸用具。じょろ。
ジヨオウ	女性の王。
ジヨガイ	取り除くこと。別あつかいにすること。
ジヨキヨ	取り去ること。取り払うこと。
ジヨギング	戸外をゆっくりと走ること。
ジヨゲン	役に立つような言葉を添えて助けること。また、その言葉。アドバイス。
ジヨコウ	鉄道車両・自動車などが、速度を落としてゆっくりと進むこと。
ジヨシ	女の子。女児。娘。
ジヨシユ	仕事の手助けをする人。アシスタント。
ジヨセイ	女。
ジヨセツ	降り積もった雪を取り除くこと。
ジヨソウ	男性が女性の装いをすること。
ジヨノクチ	大相撲の番付で最も下に記される地位。物事が始まったばかりのところ。
ジヨバン	物事の始まったばかりの段階。
ジヨホウ	割り算。
ジヨメイ	名簿からその名前を取り除くこと。団体の構成員としての資格を奪うこと。
ジヨユウ	女性の俳優。
ジリキ	自分ひとりの力。自分自身の働き。
ジリツ	他からの支配や援助を受けず、自分の力だけで物事を行うこと。ひとりだち。
ジリヨク	磁石の磁極の間に働く力。
ジレイ	個々の具体的な実例。
ジロン	かねてから主張している自分の説・意見。持説。
ジンカイ	非常に人の多いことを海にたとえて言う言葉。「○○○○戦術」
ジンカク	独立した個人としての人間性。人の性格・品格。
ジンケン	人が生まれながらに持っている権利。
ジンケンヒ	諸経費のうち、人の労働に対して支払われる経費。
ジンコウ	一つの国や、一定の地域に住んでいる人の数。
ジンザイ	役に立つ人。有能な人物。
ジンシユ	ひふや毛の色などの、体の特徴やちがいで分けた人間の種類。
ジンジ	会社・組織などで、構成員の地位・職務・能力・進退などに関する事柄。
ジンジヤ	神道で神々をまつり礼拝するところ。やしろ。
ジンセイ	人がこの世に生きている間。生涯。
ジンソク	きわめて速いこと。非常にすばやいこと。
ジンゾウ	脊椎動物に見られる、体内の不用物質を尿として排泄し、体液の調節を行う泌尿器官。
ジンタイ	人間の体。
ジンチ	人間の知恵。
ジンフゼン	腎臓の生理機能が低下した状態。
ジンブツ	描写・言及の対象としての人間。人。人柄。「登場○○○○」
ジンメイ	人の命。
ジンモン	問いただすこと。特に裁判官や警察官が取り調べるために質問を発すること。
ジンリキ	人間の力。「○○○○車」
ジンルイ	人全体のこと。
スアシ	はき物や靴下などをはいていない足。
スイアツ	水の圧力。
スイイ	河川・湖沼・海などの、一定の基準から測った水面の高さ。
スイエイ	人がスポーツや娯楽として水の中を泳ぐこと。
スイオン	水の温度。
スイカ	夏、球体の大きな実を付ける、ウリの仲間の果物。
スイギユウ	熱帯の水辺にすむ、つのが大きく横に突き出ている牛。
スイギン	常温で銀白色の液体をなす金属。
スイクチ	口で吸って使う器具や紙巻きタバコなどの、口にくわえる部分。
スイコウ	詩文の字句を何度も練り直すこと。
スイサイ	水で溶いた絵の具で彩色すること。また、その絵。「○○○○絵の具」
スイサツ	他人の心中や事情を推量して思いやること。
スイシツ	水の成分や純度などの性質。
スイシヤ	流水や落水の力で羽根車を回転させ、そのエネルギーを活用する動力装置。
スイシヨウ	六角柱状をした石英の結晶。
スイシン	水の深さ。
スイジ	ご飯を炊いたりおかずを作ったりすること。
スイジユン	物事の価値・程度・機能などを定めるときの基準となる程度。レベル。
スイス	ヨーロッパ中部の国。アルプス山脈があって、景色が美しく、観光客が多い。
スイセイ	太陽にもっとも近い惑星。
スイセン	水で洗うこと。
スイソ	最も軽い気体。燃えると酸素と結びついて水になる。
スイソウ	水を入れておくための入れ物。
スイソク	得られた情報・知識に基づいて、物事の性質・状態・なりゆきなどを推し量ること。
スイチユウ	水の中。
スイチヨク	水平線・地平線に対して直角の方向にあること。直線や平面が互いに直角に交わること。
スイツチ	電気回路の開閉や切り替えを行う装置。
スイテイ	周囲の状況や情報に基づいて、おしはかって決めること。
スイテキ	水のつぶ。
スイデン	水を引き入れて稲などを栽培する耕地。田んぼ。
スイトウ	飲料水などを入れて持ち歩くための容器。
スイドウ	飲み水を各家庭に送る設備。
スイハンキ	電気・ガスなどを熱源として飯を炊く器械。
スイブン	物に含まれている水の分量。水気。
スイヘイ	静かな水面のように平らなこと。地球の重力の方向に対して直角をなすこと。また、その方向。
スイボツ	水に沈んで見えなくなること。
スイミン	ねむること。ねむり。
スイミング	水泳。泳ぐこと。
スイメン	水の表面。
スイモン	用水路や貯水池などに設け、開閉によって水の流れを調節する門。
スイヨウ	火曜日の次の日。
スイリ	すでにわかっていることをもとにして、まだわかっていないことを推し量ること。「○○○小説」
スイリヨウ	水の分量。みずかさ。
スイリヨク	水の力。水の勢い。流水や落水によって生じるエネルギー。
スイロン	ある事実をもとに、未知の事柄を推し量って論じること。また、推理・推察によって結論を導くこと。
スウガク	数・量・図形などの性質について研究する学問。
スウシキ	数・量などを表す数字や文字を計算記号で結びつけたもの。
スウジ	数を表す文字。数で表されている事がら。
スウチ	計算したり、数えたりして出した数。
スウハイ	尊いものとして、心からうやまうこと。
スウリヨウ	数と量。また、数で表した量。
スエ	これから先。将来。一番年下の子。
スエツコ	兄弟のうち、最後に生まれた子。一番年下の子。
スカウト	スポーツ・芸能界や企業などで、有望な新人や優秀な人材を発掘して自分の側に引き入れること。
スカシ	紙を明かりに透かすと見える文字や模様。千円札や一万円札などにある。
スカート	腰から下をおおう女性用の衣服。
スガオ	化粧や変装をしていないときの、自然のままの顔。
スガタ	体の形。着物を着たときのかっこう。身なり。
スキ	物と物との間のわずかにあいている部分。気のゆるみ。
スキマ	二つの物の間にあいている狭い空間。あき。
スキマカゼ	戸・障子・壁などのすき間から吹き込む風。
スキヤキ	牛肉にネギ・豆腐などを添え、醤油・砂糖・みりんなどで味付けしながら煮焼きした鍋料理。
スキー	細長い板を足に付けて雪の上をすべるスポーツ。
スギ	日本特産の常緑高木。葉は針状で密生。材木は建築・造船・土木など、用途が広い。
スクイ	救うこと。助けること。
スクラツプ	新聞・雑誌などの切り抜き。くず鉄。
スクリーン	映画の映写幕。銀幕。
スクープ	新聞・雑誌などで、他の報道機関を出し抜いて重大なニュースをつかみ、報道すること。また、その記事。
スケダチ	人に加勢や助力をすること。また、その人。
スケツチ	写生。写生画。写生文。
スケツト	加勢する人。手助けをする人。
スケート	底に金具の付いた靴を履いて氷の上をすべるスポーツ。
スケール	物事の規模。人物の度量。長さや角度をはかる器具。
スゴウデ	普通の人にはできないような、並外れた技量をもっていること。
スゴロク	さいころの目の数で駒（こま）を進めて最初にあがりに来た人が勝ちになる遊び。
スシ	酢を加えた飯に魚・卵・野菜などを添えた食べ物。日本食。
スジ	繊維状のもの。細長い線状、糸状のもの。一続きにつながっているもの。
スス	不完全燃焼のときに出る黒い粉。
ススキ	イネ科の多年草。秋、黄褐色の穂をつける。月見のときに使う。
ススハライ	家の中のすすやほこりを払ってきれいにすること。
スズ	球形をした鳴り物。
スズムシ	昆虫。雄は、秋に前ばねを立ててリーンリーンと鳴く。
スズメ	日本でよく見られる鳥。頭は茶褐色、背面は褐色、顔と腹面は灰白色。頬と喉に黒い斑がある。
スズメバチ	日本で最も大きくて凶暴なハチの一種。針は毒性が強く、人畜に被害を与える。
スズリ	墨を水ですりおろすために使う道具。
スソ	衣服などの下の方の地面に近い部分。山のふもと。首の後ろのかみの毛。
スタジオ	写真・映画・テレビなどの撮影場。放送室。工房。アトリエ。
スタツフ	ある仕事のために、それぞれの役割をもってはたらく人たち。
スタミナ	体力。精力。持久力。
スタンバイ	いつでも本番に入れる態勢をとること。また、その準備完了を示す合図。
スタンプ	印章。郵便物などに押す消印。
スター	英語で星のこと。人気がある俳優・芸能人・スポーツ選手などの人。
スタート	英語で始めたり出発したりすること。
スダコ	ゆでたタコを薄く切って三杯酢などをかけた酢の物。また、ゆでたタコを酢に漬けた食品。
スダチ	鳥のひなが成長して巣から飛び去ること。巣離れ。
スダレ	細く割った竹や葦（あし）を糸で編み重ねたもの。つり下げて日よけ・目かくしなどにする。
ステゼリフ	立ち去るときに相手の返事を求めないで言い捨てるせりふ。
ステンレス	クロム・ニッケルなどの金属を添加してさびがつきにくくした合金。
ステーキ	厚く切った肉を鉄板などで焼いた料理。
ステージ	舞台。段階。
ステータス	社会的地位。身分。
スデ	手に何も持っていないこと。手に何もつけていないこと。持ち物が何もないこと。
ストツプ	止まること。止めること。「とまれ」の合図・信号。
ストラツプ	つりひも。
ストロー	麦わら。液体を飲むために用いる細い管。
ストーブ	薪（まき）・石油・ガス・電熱などを利用する室内用暖房器具。
スドオリ	立ち寄らないでそのまま通り過ぎること。
スナ	石がくだけてできた細かいつぶ。
スナアラシ	砂漠などで起こる、砂を含んではげしく吹く強風。
スナツク	軽い食事。軽食。手軽に食べられる袋菓子。手軽に食事ができる飲食店。
スナドケイ	時計の一種。中央のくびれたガラス容器に砂を入れ、くびれを通って下に落下する砂の量で時間を測る。
スナハマ	砂地の浜辺。
スナバ	公園・校庭などの一部を区切って砂を入れ、子供が遊べるようにした場所。
スナブロ	熱せられた砂に体を埋めて温まること。砂湯。
スナボコリ	細かい砂が舞い上がってほこりのように見えるもの。
スナヤマ	砂が体積して小高くなった所。砂丘。
スネ	ひざから足首までの間で、前の方の部分。
スノモノ	魚介・野菜・海藻などを合わせ酢で調味した料理。
スハダ	何も衣服をつけていない肌。何も化粧をしていない肌。
スパイス	香辛料。香味料。
スピーカー	音や声を電気の力で大きくする装置。
スピーチ	演説。特に会合・パーティーなどに集まった人の前でする短い話。
スピード	英語で速さのこと。
スプレー	液体に圧力をかけ、霧状に噴出させて吹き付けること。また、その装置。霧吹き。
スベリダイ	子供の遊具の一つで、斜めの長い面をすべって遊ぶ設備。
スベリドメ	すべるのを防ぐためのもの。
スペイン	ヨーロッパ南西部のイベリア半島にある国。首都はマドリード。
スペース	空間。空き。宇宙空間。
スポイト	ガラス管の一端にゴム袋をつけた器具。液体を吸い上げて他のものに移し入れるときに使う。
スポンサー	資金を出してくれる人。出資者。民間放送で番組の広告主。
スポーツ	運動や競技のこと。
スマイ	住んでいる家。暮らしている所。
スミ	木などが燃えた後に残る黒い物。
スミエ	墨の濃淡だけで描いた絵。水墨画。
スミカ	住む所。動物などが住んでいる所。
スミビ	木炭でおこした火。
スミヤキ	炭火で焼くこと。木材を蒸し焼きにして木炭を作ること。
スミレ	多数の葉が根元から生え、春、濃い紫色の花を開く多年生植物。
スモウ	土俵の上で、相手をたおしたり、外に出したりすると勝ちになる競技。
スモウトリ	相撲を取ることを職業にする人。力士。
スリガラス	表面を研磨剤ですって不透明にしたガラス。くもりガラス。
スリコギ	すり鉢に入れたものをすりつぶすのに使う、先の丸い棒。
スリツパ	足の先をすべり込ませてはく、室内用の上履き。
スリツプ	英語ですべること。
スリバチ	すりこぎで食品をすりつぶすのに用いる鉢。
スリミ	魚肉をすり鉢などですりおろしたもの。
スルメ	内臓を取り除いたイカを干した食べ物。
スローガン	広く一般に浸透させるために、運動の趣旨や団体の主義・主張などを簡潔に言い表した語句。標語。
スンポウ	物の長さのこと。
スーツ	同一の布地で作った上下そろいの洋服。
スープ	西洋料理で煮出し汁を元に作られる汁物。
ズイヒツ	自分の見聞・体験・感想などを、思うままに自由な形式で書きつづった文章。随想。エッセー。
ズカイ	図を用いて説明すること。また、その書物。
ズカン	写真や絵を使っていろいろなものを系統的に解説した書物。
ズキン	頭や顔をおおう布製のかぶりもの。
ズケイ	物の形を点や線や面を使って表したもの。
ズコウ	図画・工作の略。
ズサン	物事のやり方がぞんざいで誤りや手抜きが多いこと。
ズジヨウ	頭の上。頭の上の方。
ズツウ	頭が痛むこと。頭の痛み。
ズノウ	脳。頭。脳の働き。考える力。
ズヒヨウ	図と表。
ズボシ	的の中心の黒い点。目当ての所。思惑。
ズメン	土木・建築・機械などの構造や設計を詳細に示した図。設計図。
ズレ	位置・時間などが少しはずれていること。考え方や感じ方に少しへだたりがあること。食い違い。
セイイキ	その人が出すことのできる声の高低の範囲。
セイエン	声をかけて応援すること。
セイカ	いい結果。
セイカイ	正しい答え。
セイカク	正しくて確かなさま。
セイカツ	生きて活動すること。くらしを立てること。生計。
セイガン	自分の希望がかなうように願い出ること。国民が国または地方公共団体に対して文書で希望を申し出ること。
セイキ	西暦で年を百年ごとに区切って表す単位。
セイキユウ	お金や物などを相手に求めること。
セイギ	行いが正しく、筋道が通っていること。
セイギヨ	機械などが目的にそって動くように操作・調節すること。
セイクラベ	背の高さを比べ合うこと。丈比べ。
セイケツ	よごれがなく、衛生的なさま。
セイコウ	やろうとしたことが思ったとおりできること。
セイサ	詳しく調べること。
セイサク	芸術作品を作ること。
セイサン	人間が必要とするものを新しく作り出すこと。
セイザ	明るい星や目立つ星を結んで、いろいろな動物や人物などに見立てたもの。
セイザイ	調合して薬剤を製造すること。また、その製品。
セイシキ	決められたとおりの正しい方式にのっとっていること。公式。
セイシツ	その物が持っている特徴。
セイシユン	人生の若い、元気な希望にあふれる時期。
セイシヨ	キリスト教の正典。バイブル。
セイシヨク	生物の個体が種の保存のために自己と同じ種類の新しい個体をつくりだすこと。
セイシン	人の心。心の持ち方。
セイジ	国の主権を持っている人が領土・人民を治めること。
セイジカ	政治に携わる人。議会の議員のこと。
セイジツ	真心がこもっていて、うそ・偽りがないこと。
セイジユク	穀物・果実などが十分に熟すこと。人の心身が十分に成長すること。
セイジヨウ	正しく、普通であるさま。
セイジン	心身ともに大人になった人。二十歳以上。
セイスウ	小数が付かない、はしたのない数。
セイセイ	物が生じること。生じさせること。物を作り出すこと。
セイセキ	結果。点数。できばえ。
セイソウ	きれいに掃除すること。
セイソク	動物がある環境の中で生きること。
セイゾウ	材料に手を加えて品物を作り上げること。
セイゾロイ	多くの人々が一か所に集まること。
セイゾン	生きてこの世にいること。
セイタイ	のどの中央部にある左右一対の発声器官。
セイダイ	集会・儀式・事業などが大規模に行われること。
セイチ	宗教上、特に神聖視されている土地。
セイチユウ	昆虫・クモ類などの成熟した個体。
セイチヨウ	大きく立派になること。
セイツウ	ある物事についてくわしく知っていること。
セイテイ	法律・規則などを定めること。
セイテツ	鉄鉱石を製錬して銑鉄を作ること。
セイテン	晴れた空。よい天気。
セイデンキ	静止して流れない電気。
セイト	中学校・高等学校で教育を受けている人。
セイトウ	法規・道理などにかなっていて正しいこと。
セイド	国・社会・団体などを秩序にしたがって運営・維持していくための決まり。
セイドウ	銅とすずの合金。ブロンズ。
セイニク	骨・筋などを取り除いた上等の食用肉。
セイネン	二十代を中心とする若い男女。
セイノウ	機械・道具などの、仕事をする能力。
セイハ	競争相手をおさえつけて権力を握ること。試合などで優勝すること。「世界○○○」
セイヒヨウ	人工的に氷を作ること。
セイヒレイ	二つの数量の比が常に一定で、どちらかが増えるともう一方が増えるという関係。
セイヒン	商品として製造された品物。
セイビ	すぐ使えるような状態に準備を整えておくこと。
セイフ	国の政治を行う機関。内閣を指す。
セイフク	その集団・団体などに所属する人が着ることを定められている衣服。ユニフォーム。
セイブ	ある地方の中の、西の部分。
セイブツ	生命を持っているもの。生き物。
セイヘン	急激に起こる政権の変動。
セイベツ	男か女かの区別。
セイホウ	物の作り方。製造の方法。
セイボ	年末にその年お世話になった人などに贈り物をすること。また、その贈り物。
セイマイ	玄米をついて外皮をとり、白い米にすること。
セイミツ	細部まで巧妙に作られていること。
セイメイ	生物が生物として生きるもとになる力で、それがなければ死んでしまうもの。
セイモン	音声を周波数分析した結果をしま模様の図に表したもの。また、その特徴。
セイヤ	クリスマスの前夜。クリスマスイブ。
セイヤク	医薬品を製造すること。
セイユウ	声だけで出演する俳優。
セイヨウ	日本・中国などに対してヨーロッパやアメリカを指して言う言葉。欧米。
セイリ	乱れているものをかたづけて、きちんとすること。
セイリツ	物事が成り立つこと。
セイリヨク	勢いや力。
セイレキ	キリストが誕生した年を紀元元年とする年代の数え方。
セイレツ	きちんと列を整えて並ぶこと。
セイロン	道理にかなった正しい意見や議論。
セカイ	地球上のすべての地域・国。
セカイイチ	世界の中で一番であること。
セキ	のどが刺激を受けたときに起こる、短くて強い息。
セキエイ	二酸化珪素からなる鉱物。
セキザイ	土木・建築・墓碑・彫刻などに使用する石。
セキジユン	座席に並ぶ順序。
セキズイ	背骨の中を通る白色・棒状の神経の束。
セキセツ	降り積もった雪。雪が降り積もること。
セキゾウ	石の像。
セキタン	黒色または褐色の固形の燃料。
セキドウ	地軸に垂直で、地球の中心を通る平面が地表面と交わる線。
セキニン	任されて、自分でしなければならない任務。
セキハン	もち米に、小豆などを混ぜて作った赤い飯。
セキメン	恥じて顔を赤くすること。また、恥じること。
セキユ	地中から産出する液体の燃料。
セケン	世の中。人間が集まってくらしているところ。
セジヨウ	かぎをかけること。
セスジ	背中の中心線。
セセラギ	浅瀬などを流れる水の音。また、小さな流れ。
セソウ	世の中のありさま。社会の風潮。
セゾク	世の中の風俗・習慣。世の中。俗世間。
セタイ	同じ住居や生計のもとで生活する人たちの集合体。
セタケ	背の高さ。身長。
セダイ	同時代に生まれた、ある年齢層の人々。ジェネレーション。
セツ	論理的にねられた意見。主張。
セツカイ	手術などで体の一部を切り開くこと。
セツキ	石で作った道具。昔の人が使った石の道具。
セツキヤク	客をもてなすこと。
セツキン	近づいてくること。
セツケイ	機械類の製作や建造物の工事などに際し、完成したときの形や構造を図面などによって具体的に示すこと。人生や生活の計画を立てること。
セツケン	油に苛性ソーダを混ぜて固めて作った洗剤。
セツコウ	硫酸カルシウムからなる鉱物。セメント・肥料・型取りなどに使われる。ギブス。
セツシユ	取り入れて自分のものにすること。
セツジヨ	人体の病巣などを切って取り除くこと。
セツスイ	使用する水の量を節約すること。
セツセン	なかなか勝敗の決まらない激しい戦い。
セツゼイ	適法に税負担を軽減すること。
セツゾク	二つ以上のものをつなぎ合わせること。
セツダン	切り離すこと。
セツチ	機械・設備などを備えつけること。
セツチヤク	物と物をぴったりくっつけること。
セツテイ	物事を作り定めること。
セツデン	使用する電気の量を節約すること。
セツトク	よく説明して、わからせること。
セツパク	ある時刻・期限などが差し迫ること。緊張した状態になること。
セツビ	必要な建物・装置・機器などを備え付けること。また、備え付けたもの。
セツメイ	意味がよくわかるように述べること。
セツヤク	物をむだにせず、切りつめること。
セナカ	体の後ろ側の、腰から肩までの部分。
セノビ	つま先立ちになって背を伸ばし、できるだけ体を高くすること。
セバンゴウ	スポーツの選手が背中につける番号。
セボネ	背中の中心を走る太い骨。脊柱（せきちゅう）。
セミ	夏に木の幹にとまって大きな声で鳴く昆虫。
セメント	石灰石・粘土などを焼いて粉末にしたもの。または、無機質接着剤の総称。
セリフ	舞台や映画などで役者が役の人として言う言葉。
セロリ	セリ科の一年草または二年草。いい香りがする。別名オランダミツバ。
セワ	めんどうを見ること。手数や苦労。
セン	百の十倍。
センイ	戦おうとする意志。闘志。
センカイ	円を描くように回ること。
センガン	水や薬剤などで目を洗うこと。
センキヤク	先に来ている客。
センキヨ	投票などで人を選び出すこと。
センキヨク	多くの楽曲の中から曲目を選び出すこと。
センギリ	大根・にんじんなどを細長く刻むこと。また、刻んだもの。
センゲツ	今月の一つ前の月。
センゲン	広く世間にはっきり言うこと、知らせること。
センコウ	香料の粉末を線上に練り固めたもの。
センゴ	戦争の終わったのち。
センザイ	食器・野菜・衣服などを洗うために使う薬品。
センシ	戦場で戦う兵士。
センシヤ	自動車や鉄道車両の車体に水をかけて洗うこと。
センシユ	競技などに出るために選ばれた人。
センシユウ	今週の前の週。
センジツ	さほど遠くない過去のある日。このあいだ。
センセイ	学校の教師。教えてくれる人。相手を尊敬して呼ぶときの言葉。
センソウ	国と国とが武力を使って争うこと。
センゾ	その家で、今生きている人より前の代の人たち。
センタイ	船舶の本体。
センタク	よごれた物を洗ってきれいにすること。
センター	中心。中央。中心的機能を果たす機関・施設・場所。
センチ	戦争の行われている土地。また、戦争のために軍隊がとどまっている土地。戦場。
センチヤク	先に到着すること。「○○○○○順」
センチヨウ	船舶の乗組員の長。キャプテン。
センテ	囲碁・将棋で先に着手すること。人に先んじて事を行うこと。
センテイ	果樹・庭木などの枝の一部を切り取ること。
センデン	商品の名前や特長、ある事がらの主張などを世間に言い広めること。
セント	都を他の地に移すこと。
センド	魚介・肉・野菜などの新鮮さの度合い。
センニユウ	ひそかに入り込むこと。忍び込むこと。
センニン	山中に住み、不老不死の術を修めて変幻自在の神通力を操るという人。
センヌキ	ビンなどの王冠やコルク栓を抜き取るための道具。
センネン	一つのことだけに心を集中すること。そのことに没頭すること。専心。
センパイ	年上の人。
センプウキ	羽を回して風を起こす機械。
センベイ	水でこねた小麦粉を油で炒った食べ物。
センベツ	ある基準によってより分けること。
センム	株式会社の取締役の一つ。社長を補佐し、会社の全般的な管理業務に当たる。「専務取締役」の略。
センメイ	色・形などがあざやかなこと。はっきりしていて他とまぎれないこと。
センモンカ	ある特定の分野を専門に研究・担当し、それに精通している人。エキスパート。
センヨウ	そのことだけに使うこと。決まった人だけが使うこと。
センリユウ	十七音からなる、人事、風俗、世相などを鋭くとらえた短詩型文学。
センレン	ねりきたえて風格・品格を高めること。みがきをかけて優雅・高尚なものにすること。
センロ	列車・電車などが通る道筋。レールのこと。
セーター	毛糸で編んだ上着。
セール	売り出し。特売。
セールス	販売。外交販売。外交販売員。
ゼイ	国費や公費をまかなうため、国や地方公共団体が国民から強制的に取り立てる金銭。
ゼイカン	港・空港・国境などに設置され、関税の徴収、輸出入貨物の取り締まりなどの事務を扱う官庁。
ゼイキン	国や地方自治体が、いろいろな経費に当てるために、住民から集めるお金。
ゼイコミ	税金が含まれた金額。
ゼイシユウ	徴税によって得る国や地方公共団体の収入。
ゼイセイ	税に関する制度。
ゼイタク	必要以上にお金をかけること。
ゼイニク	体に必要以上についてしまった肉や脂肪。
ゼイビキ	金額から税金を差し引くこと。また、税金を差し引いた金額。
ゼイム	租税に関する行政事務。
ゼイリシ	税務の代理・税務書類の作成・税務相談にあたることを職業にする人。
ゼイリツ	課税対象に対する税額の割合。課税率。
ゼセイ	悪い点などを直して正しくすること。
ゼツエン	縁を断ち切ること。電気や熱の伝導を断ち切ること。
ゼツキヨウ	出せる限りの声を出して叫ぶこと。また、その叫び。
ゼツケイ	きわめてすばらしい景色。
ゼツサン	この上なくほめること。この上ない称賛。
ゼツシヨク	食べ物をまったくとらないこと。
ゼツチヨウ	山の最も高い所。頂上。いただき。最高の状態。
ゼツピン	並ぶもののないほどすぐれた品物や作品。
ゼツペキ	切り立ったがけ。
ゼツミヨウ	この上なくたくみであること。
ゼニ	貨幣。金銭。お金。
ゼネコン	土木・建築工事を一括して請け負う大手の総合建設業者。
ゼリー	果物のしるや砂糖などを混ぜてゼラチンで固めた食べ物。
ゼロ	何もないこと。１よりも小さい数。
ゼンアク	善と悪。よいことと悪いこと。
ゼンイ	よい心。他人のためを思う気持ち。悪意の反対。
ゼンイン	全部の人。みんな。
ゼンオンプ	四分音符の四倍の長さの音符。
ゼンカイ	全部開くこと。開ききること。全部の力を出すこと。
ゼンガク	全部の金額。総額。
ゼンキヨク	すべての曲。ある曲のすべて。
ゼンケン	すべての権力。
ゼンゲツ	一つ前の月。先月。
ゼンコウ	学校全体。学校の全生徒。
ゼンコク	国じゅう。国全体。
ゼンゴ	物の前と後ろ。
ゼンシヤ	二つの事がらのうち、初めの方で述べたもの。
ゼンシユウ	ある個人の著作をすべて集めた書物。
ゼンシン	前へ進むこと。
ゼンジツ	一つ前の日。
ゼンセン	戦闘の第一線。気象で暖気団と寒気団が接触する境界面が地表面と交わる線。
ゼンタイ	物・事柄の全部。一まとまりのもの全部。ある領域すべて。
ゼンチ	病気やけががすっかり治ること。
ゼンチヨウ	その物の全体の長さ。
ゼンテイ	ある物事が成り立つためのもととなる条件。
ゼンデラ	禅宗の寺院。
ゼンニン	前にその任務・地位に就いていたこと。また、その人。
ゼンネン	その年の前の年。
ゼンハン	物事を二つに分けたときの前半分。
ゼンパイ	試合・勝負などのすべてに負けること。
ゼンブ	ある物事のみんな。すべて。
ゼンベイ	アメリカ合衆国全体。
ゼンポウ	前の方向。
ゼンマイ	弾力性のある薄い帯状、または線状の金属をうずまき状に巻いたもの。
ゼンヤ	ある特定の日の前の夜。
ゼンヨウ	全体の姿。内容のすべて。
ゼンリヨク	もっている全部の力。
ゼンレイ	先例。以前にあった例。前からのしきたり。
ゼンレツ	前の列。
ソイネ	寝ている人のそばに寄り添って寝ること。
ソウ	積み重なったもの。かさなり。
ソウアン	文章の下書き。文案。
ソウイ	二つの物・事柄の間に違いがあること。
ソウカイ	さわやかで気持ちがいいさま。
ソウガク	すべてを合計した金額。全額。
ソウキ	早い時期。
ソウキユウ	球技で、ボールを他の選手に投げ送ること。
ソウキン	お金を送ること。
ソウギヨウ	事業を興すこと。新しく会社や店をおこして営業を始めること。
ソウグウ	思いがけなく出会うこと。不意に出くわすこと。
ソウゲン	草が一面に生えている広い原っぱ。
ソウコ	物品を貯蔵・保管しておくための建造物。くら。
ソウコウ	自動車などが走ること。
ソウゴ	両方が互いに働きかけること。両方が同じことをし合うこと。
ソウサ	機械などをあやつって動かすこと。
ソウサイ	政党・公社などの長として全体を取りまとめる職。
ソウサク	行方のわからない人や物を組織的に探し求めること。
ソウザイ	日常の食事のおかず。
ソウシヤ	陸上競技で走る人。野球で塁に出ている攻撃側の選手。ランナー。
ソウシヨ	漢字の書体の一つ。行書をさらにくずしたもの。
ソウシヨウ	ある共通した性質・傾向などを持つ個々の物をひとまとめにして呼ぶこと。また、その呼び名。
ソウシヨク	美しくかざること。また、そのかざり。
ソウジ	ごみやちりを取ったり、ぞうきんでふいたりして、きれいにすること。
ソウジユウ	航空機・大型機械などを自分の思うままに動かすこと。
ソウジユク	果物などが普通より早く熟すること。心身の発達が普通より早いこと。
ソウスイ	水道・水路・ポンプなどで水を送ること。
ソウスウ	すべてを合計した数。全体の数。
ソウスカン	すべての人から嫌われること。
ソウセイジ	同じ母体から一回の分娩で生まれた二人の子。ふたご。
ソウゾウ	経験したことのない物事を、たぶんこうであろうと、心の中に思いえがくこと。空想。
ソウゾク	後を受けつぐこと。
ソウタイ	決まった時間よりも前に退出すること。
ソウダイ	大きくて立派なこと。
ソウダン	どうすればよいかについて、話し合ったり、ほかの人に意見をきいたりすること。
ソウチ	機械・道具などを取り付けること。また、取り付けたもの。仕掛け。
ソウチヤク	身につけること。また、器具などを取り付けること。
ソウチヨウ	朝の早いうち。朝早く。
ソウテイ	ある状況・条件などを仮に考えてみること。
ソウデン	電力を送ること。
ソウニユウ	間に差し入れること。中にはさみ込むこと。
ソウネン	働き盛りの年頃。また、その年頃の人。
ソウハク	青白いこと。血の気がなく、あおざめていること。
ソウバ	市場で取り引きされる品物の、そのときの値段。時価。
ソウビ	武器・機器・用具などを取り付けたり身に着けたりすること。
ソウフ	品物や書類を送り届けること。
ソウフウ	風や空気を吹き送ること。
ソウベツ	別れていく人を送ること。「○○○○会」
ソウホウ	あちらとこちら。両方。
ソウム	組織全体に関する事務を処理すること。また、その職や部署。
ソウメイ	理解力・判断力にすぐれ、かしこいこと。
ソウリ	内閣総理大臣の略。
ソウリヨ	僧。出家。
ソウリヨウ	品物を送るのに必要な料金。
ソウリヨク	持っているすべての力。集団・国家などの全体の力。
ソウルイ	野球で走者が塁から次の塁へ走ること。
ソエギ	草木などがたおれないように支えの木を添えること。
ソカイ	都市に集中している住民・物資・工場などを地方に分散すること。
ソクイ	君主・天皇がその位につくこと。
ソクシン	物事がはやく進むように働きかけること。
ソクセイ	農作物などを人工的に早く生長させること。
ソクセキ	手間をかけなくてもすぐにでき上がること。インスタント。
ソクタツ	特別料金を取って特定の郵便物を普通郵便物よりも早く配達する制度。また、その郵便物。
ソクダン	その場ですぐ判断して決めること。ただちに結論を出すこと。
ソクテイ	機械や器具を使って、物の大きさ・重さ・量などをはかること。
ソクトウ	質問されてその場ですぐ答えること。
ソクド	物の進む速さ。
ソクドク	本などを普通より速く読むこと。
ソクホウ	情報をすばやく知らせること。また、その知らせ。
ソクメン	物の左右の面。
ソクリヨウ	機器を用いて建造物や土地などの高低・方向・距離などを測ること。
ソコ	一番下の面。一番おくの方。
ソコアゲ	全体の水準を高めるため、最低の数値を引き上げること。
ソコク	自分の生まれた国。母国。
ソザイ	もとになる材料。芸術作品の題材となるもの。
ソシキ	組み立て。同じ目的を持った人々の集まり。同じ形や働きをもった細胞の集まり。
ソシツ	生まれつき備わっている性質。特に、将来の発達が期待される性質・能力。
ソシヨウ	訴えること。裁判によって事実の認定や法律的判断を裁判所に対して求める手続き。
ソセイ	生き返ること。よみがえること。
ソチ	ある事態の始末をつけるために必要な手続きをとること。また、その手続き。
ソツウ	意見・考えなどが支障なく相手に通じること。「意思の○○○」
ソツキ	すばやく書き記すこと。
ソツキン	権力者や身分の高い人のそばに仕えること。また、その人。
ソツギヨウ	決められた勉強を学び終えて、学校を出ること。
ソツクス	長さがくるぶしより少し上くらいまでの短い靴下。
ソツコウ	ききめがすぐに現れること。
ソツチヨク	飾ったり隠したりせず、ありのままであること。
ソツトウ	突然意識を失って倒れること。
ソツポ	よその方向。わきの方。「○○○を向く」
ソデ	着物や洋服の腕を通す部分。
ソト	建物の外部。屋外。物の外側に当たる部分。
ソトゼイ	表示価格に消費税が含まれていないこと。
ソトボリ	城の外を囲んでいる堀。
ソトマワリ	会社などで、外出して取引先などを回って歩くこと。また、その仕事。
ソナエ	起こるかもしれないことに対して用意をしておくこと。
ソバ	すぐ近くのこと。
ソバカス	顔面の皮膚に現れる褐色の小さな斑点。
ソフ	父や母の父。おじいさん。
ソフアー	背もたれとひじかけのある、ゆったりとした長椅子。
ソフボ	祖父と祖母。
ソブリ	動作・態度や表情に表れた様子。
ソプラノ	女声の最高音域。また、その声域の歌手。
ソボ	父や母の母。おばあさん。
ソムリエ	レストランなどで、ワインの注文を受ける専門職。
ソメモノ	布などを染めること。また、染めた物。
ソヨカゼ	そよそよと静かに吹く風。びふう。
ソラ	大地のずっと上の方に見える所。
ソラマメ	マメ科の一年生または二年生植物。さやは円筒形。種子は食用。さやが空に向かう。
ソラミミ	実際には声や物音がしないのに耳に聞こえたように思うこと。
ソラモヨウ	空の様子。天候の様子。
ソリ	雪や氷の上をすべらせて、人や荷物を運ぶ乗り物。
ソロ	歌唱・演奏などを一人で行うこと。独唱。独奏。単独。
ソロバン	日本や中国で用いられた計算器具。長方形の枠の中にいくつかの珠（たま）を貫いた軸を並べたもの。
ソン	利益を失うこと。また、失ったもの。
ソンエキ	損失と利益。損得。
ソンケイ	その人の人格・識見・業績・行為などをすぐれたものとして尊び敬うこと。
ソンザイ	物や人が実際にあること。
ソンゾク	引き続いて存在すること。引き続き残しておくこと。
ソンチヨウ	地方公共団体である村の長。
ソントク	損失と利益。損益。
ソース	料理の味付けに使うしる。
ソーセージ	動物の腸に、香料や調味料を加えてひきつぶした肉を詰め、煮沸、乾燥、もしくは燻製（くんせい）した食べ物。
ゾウ	アフリカやインドに住む、長い鼻の大きな動物。
ゾウエキ	利益が増えること。
ゾウエン	庭園・公園などをつくること。
ゾウカ	数・量が増えること。また、増やすこと。
ゾウガク	金額を増やすこと。
ゾウキ	内臓の器官。
ゾウキヨウ	人員・設備などを増やして機能を強めること。
ゾウゲ	象の上あごにある長く伸びた二本の門歯。象の牙。
ゾウゲン	増えることと減ること。増やすことと減らすこと。
ゾウゴ	言葉を新しく作り出すこと。また、その言葉。
ゾウサツ	一定の部数を印刷した後、さらに追加して印刷すること。また、その印刷物。
ゾウシ	企業が資本金を増やすこと。
ゾウシユウ	収入・収穫が増えること。
ゾウシヨク	生物の細胞・組織や個体の数が増えること。
ゾウスイ	米飯に野菜・魚介・肉などを入れ、味付けして煮たもの。おじや。
ゾウセツ	施設・設備などをさらに増やすこと。
ゾウセン	船を建造すること。
ゾウゼイ	税金を増やすこと。
ゾウチク	すでにある建物に付け加えて建てること。建て増し。
ゾウニ	もちをさまざまな具とともに煮た汁もの。主に正月の祝いに食す。
ゾウリ	底が平らで鼻緒が付いているはきもの。
ゾウリヨウ	分量を増やすこと。また、増えること。
ゾクゴ	世間で日常的に使われている話し言葉。改まった場では使いにくい卑俗な言葉。
ゾクシユツ	同じようなことが次から次へと続いて起こること。
ゾクセイ	ある事物に備わる固有の性質。
ゾクセツ	確かな根拠もなく世間一般に言い伝えられている説。
ゾクヘン	論文・小説・映画などで、前の編に続く編。
ゾロメ	二つのさいころを振ったとき、同じ目が出ること。
タイ	海にすむ、体が平たい、おめでたい魚。
タイアタリ	自分の体を相手にぶつけること。
タイアン	代わりとなる案。
タイイク	体をきたえ、強くするための運動をする教科。
タイイン	病気やけがで入院していた人が、治って病院を出ること。
タイエキ	動物の体内で、細胞外にあって流動する液体の総称。
タイオウ	相手や周囲の状況に応じて物事を行うこと。
タイオン	動物の体の温度。
タイカイ	会からしりぞき、会員でなくなること。
タイカク	肉づき・骨格などから見た、身体のかっこう。からだつき。
タイガ	大きな川。「○○○小説」
タイキ	地球をとりまいている空気。
タイキユウ	長い間もちこたえること。
タイキヨク	碁または将棋で、盤に向かい合って対戦すること。
タイキン	多額の金銭。
タイギゴ	同一言語の中で、その意味が対の関係、あるいは正反対の関係にある言葉。
タイグン	たくさんの動物などが集まってつくる大きな群れ。
タイケイ	体の形。からだつき。
タイケツ	二人の人物が直接向かい合って、どちらが強いか、正しいかをはっきり決めること。
タイケン	自分で実際にやってみること。または、やって身に付けたこと。
タイコ	金属や木の筒に皮をはり、ばちや手でたたく楽器。
タイコウ	互いに勝ちを争って競うこと。張り合うこと。
タイコク	国土の広い国。また、国力の盛んな国。
タイサク	相手の出方や事件の成り行きに対応してとる方法・手段。
タイザイ	よその土地に行って、そこにある期間とどまること。
タイシツ	個人に備わっている体の性質。団体・組織などにしみついている性質。
タイシヤ	その日の勤務を終えて会社から退出すること。勤めている会社を辞めること。
タイシユウ	体から発散されるにおい。
タイシヨ	ある出来事や状況に応じて適切な処置をとること。
タイシヨウ	最も優秀なものに与えられる賞。グランプリ。
タイシヨク	勤めている会社などをやめること。
タイシン	建築物などが地震に対して強いこと。
タイジ	母親の胎内で成育中の子。
タイジユウ	体の重さ。
タイジヨウ	その場所・会場・競技場などから出ていくこと。
タイセイ	特定の政治権力によって支配されている社会の様式。
タイセキ	立体が空間の中で占める量。
タイソウ	健康でバランスのとれた体を作るため、体の各部分を規則正しく動かす運動。
タイダン	ある事柄について二人で語り合うこと。向かい合って話すこと。
タイチヨウ	体の調子。体の状態。
タイデン	物質が電気を帯びること。
タイトウ	あるものが勢いを増してくること。
タイトル	表題。記事の見出し。選手権。
タイド	ものの言い方。物事に取り組む姿勢。ある物事についての心の持ち方。
タイドウ	母胎内で胎児が動くこと。
タイナイ	体の内部。
タイネツ	高熱に耐えること。高熱によって変質しないこと。
タイハン	全体の半分よりもはるかに多い数量。大部分。
タイヒ	二つのものを比べて、その相違や特性をはっきりさせること。
タイフウ	発達した熱帯低気圧によって起こる暴風雨。
タイプ	物事の型や種類。文字を打ちこむこと。
タイボウ	実現や出現を待ち望むこと。
タイボク	大きな立ち木。大樹。
タイミング	時間が合うこと。時間を合わせること。
タイム	時間、時刻。時間を取って中断すること。
タイメン	互いに向き合うこと。
タイモウ	体に生えている、髪の毛以外の毛。
タイヤ	自転車や自動車の車輪の外側に付いているゴムの輪。
タイヨウ	昼間に空で光り輝き、地球に膨大な光と熱をもたらす天体。
タイリク	広くて大きな陸地。
タイリツ	二つの意見などが食い違い、張り合うこと。
タイリユウ	液体や気体が熱せられると、密度が小さくなって上昇し、密度の大きい冷たい部分と入れ替わって起こる流れ。
タイリヨウ	数量が多いこと。たくさん。多量。
タイリヨク	病気をはねのけたり、仕事や運動をする体の力。
タイル	壁・床などに張り付ける陶磁器の薄板。
タイワ	直接向かい合って互いに話をすること。また、その話。
タウエ	水田に稲の苗を植えること。
タオル	水分をよく吸い取る厚手の綿織物。
タカ	ワシより少し小さく、するどいつめと曲がったくちばしを持った鳥。
タカクケイ	三つ以上の線分で囲まれた平面図形。
タカサ	高いこと。高いことの度合い。
タカトビ	高く飛び上がること。
タカナミ	高く立つ波。大波。
タカネ	値段が高いこと。高い値段。
タカラ	たいへんきれいだったり、すばらしかったりして、値打ちが高いもの。
タカラブネ	宝物や七福神を乗せた帆掛け舟。また、それを描いた絵。縁起がいいとされる。
タカラモノ	宝として大切にする物品。ほうもつ。
タガク	たくさんのお金。
タキ	がけから流れ落ちる川の流れ。
タキギ	燃料にするための木。まき。
タキダシ	飯を炊いて被災者や現場で働く人などに配ること。
タキツボ	滝の水が落ち込んで深いふちとなった所。
タキビ	地面で木の葉などの不要な物を集めてたくこと。また、その火。
タクアン	生干しの大根を塩とぬかで漬け込んだ漬物。たくわん。
タクシー	客を乗せて運ぶ自動車。距離や時間に応じたお金を取る。
タクハイ	新聞、牛乳、荷物などを個々の家に配達すること。
タクワエ	たくわえること。また、たくわえたもの。
タケ	くきがまっすぐでいくつもの節があって中が空っぽの植物。
タケウマ	子供の遊具で、二本の竹ざおにつけた足がかりに足を乗せ、さおの上部をにぎって歩くもの。
タケクラベ	背たけを比べること。せいくらべ。
タケザイク	竹を材料にして道具・器物などを作ること。また、その道具・器物。
タケザオ	竹の幹で作ったさお。
タケヅツ	竹を横に切って作ったつつ。
タケトンボ	薄くプロペラ状にけずった竹の中心に軸を差し込んで作ったおもちゃ。
タケノコ	竹の地下茎から生え出る若芽。食用。
タケヤブ	竹がたくさん生えている所。
タコ	軟体動物の一つで、八本の足がある。足には二列の吸盤がある。
タコアシ	タコのように一か所から何本も分かれ出ていること。
タコク	よその国。外国。自分の生まれた土地以外の地。
タコツボ	タコを捕まえるためのつぼ。
タコヤキ	水に溶いた小麦粉に、刻んだタコの切れ端などを入れ、半球形の型で焼いた食べ物。
タサイ	さまざまな才能をもっていること。
タシ	不足分を補うもの。
タシザン	二つ以上の数を加えて、その和を求める計算。
タシヤ	自分以外の人。ほかの人。
タシヨウ	数量が多いことと少ないこと。
タスウ	数が多いこと。
タスウケツ	会議などで、賛成者の多い方の意見によって物事を決めること。
タスケ	助けること。助ける人。
タスケブネ	水上での遭難者や遭難船を救助するために出す船。人が困っているときに力を貸すこと。
タズネビト	消息がわからなくて探されている人。
タソガレ	夕方の薄暗いころ。夕暮れ。
タタキ	たたくこと。肉などを包丁でたたくこと。また、その料理。
タタキウリ	大安売り。投げ売り。
タタミ	イグサという植物を編んで作ったごさをぬい付けた、しき物。
タダ	お金がいらないこと。
タチアイ	証人・参考人などとして、その場に同席する人。
タチオヨギ	頭を水面上に出し、体を立てた姿勢で泳ぐこと。
タチギレ	火が十分に燃えないまま途中で消えてしまうこと。
タチグイ	立ったまま食べること。「○○○○そば」
タチゲイコ	演劇で、脚本の読み合わせを終えた後、立って動作や表情をつけながら稽古（けいこ）すること。また、その稽古。
タチスガタ	立っている姿。
タチバ	その人が置かれている位置や地位のこと。
タチバナシ	立ったままで人と話をすること。また、その軽い内容の話。
タチヨミ	本屋の店頭で、本を買わないで立ったまま読むこと。
タツキユウ	中央にネットを張った長方形の台をはさみ、競技者がラケットでセルロイド製のボールを打ち合う競技。
タツシヤ	上手なこと。健康なこと。
タツジン	ふつうの人が及ばないほど、学問やわざなどが優れて、うまい人。
タツセイ	なしとげること。
タツチ	英語で触れることやさわること。
タツピツ	文字や文章を上手に書くこと。また、その書いたもの。
タツマキ	激しい風の渦巻き。
タテガキ	上から下の方向に文字を順に書くこと。
タテガミ	雄のライオンの顔の周囲や、馬の首の後ろに生えている、ふさふさした長い毛。
タテゴト	縦に張った弦を指でかき鳴らす楽器。
タテジマ	縦の方向に走ったしま模様。
タテツケ	戸・障子などの開閉の具合。
タテツヅケ	同じことや似たようなことが続けて行われること。続けざま。
タテナガ	横より縦のほうが長いこと。
タテフダ	人々に知らせることを書いて所定の場所に立てる木の札。
タテブエ	管を縦に構えて吹く笛。
タテマエ	表向きそのようになっている方針。
タテモノ	人が住んだり仕事をしたり、品物を保管したりするために、木や石や鉄などを使って建てたもの。
タテユレ	垂直に揺れること。
タナ	板などを横にわたして物をのせるところ。
タナバタ	彦星（ひこぼし）と織姫（おりひめ）が年に一回会うという伝説に基づく七月七日の祭り。
タナボタ	「棚からぼた餅」の略。
タニ	山と山との間の、深くくぼんだところ。
タニガワ	谷間を流れる川。渓流。
タニマ	谷の底のほうの狭い土地。谷の中。谷あい。
タニン	自分以外の人。そのことに関係のない人。
タヌキ	体は茶色で、目の周りが黒い、東南アジアにすむ動物。
タネ	新しく木や草の芽の生えてくるもとになるもの。種子。
タネアカシ	物事の仕組みや、手品の仕掛けを明かすこと。
タネイモ	種とする芋。
タネウシ	種付け用に飼う雄の牛。
タネウマ	種付け用に飼う雄の馬。
タネツケ	品種改良や繁殖の目的で、雌に優良種の雄を交配させること。
タネビ	いつでも火がおこせるように用意しておく小さな火。
タネマキ	田畑や苗床に種をまくこと。
タノシミ	自分が楽しんでいるもの。将来のよい状態を期待すること。
タノミ	たのむこと。依頼すること。あてにすること。
タハタ	田んぼと畑。
タハツ	多く発生すること。
タバ	一つにまとめて束ねること。
タビ	いつも住んでいる自分の家をある期間、はなれ、どこかへ出かけること。
タビサキ	旅をしている土地。旅行先。
タビジ	旅をする道筋。旅の途中。
タビビト	旅をする人。
タベアルキ	土地の食べ物や名物料理をあちこち食べてまわること。
タベゴロ	食べるのにちょうどよいころあいや時節。
タベスギ	度を越して食べること。食いすぎ。
タベモノ	食べる物。
タホウメン	多くの方面。いろいろな分野。
タボウ	非常にいそがしいこと。
タマ	丸い形をしたもの。
タマイレ	紅白のチームに分かれて、さおの先につけたかごの中にそれぞれ玉を投げ入れる競技。
タマゴ	鳥・虫・魚などのめすが生むもの。それがかえると子どもになる。
タマゴヤキ	溶き卵を焼いた料理。
タマツキ	追突された車両が前へ押し出され、そのまた前の車両に追突する状態。
タマテバコ	美しい手箱。浦島太郎が竜宮の乙姫から送られた手箱。
タマネギ	地中に玉のようにふくらんだ茎を作る野菜。オニオン。
タマノコシ	女性が婚姻などによって富貴の身分になること。
タマモノ	ほうびの品物。贈り物。結果として得たよい事や物。
タミ	国家・社会を構成する人々。人民。国民。
タメイケ	灌漑（かんがい）や消火に用いる水をためておく人工の池。用水池。
タメシ	やったことのないことを実際にやってみること。
タメンタイ	四つ以上の平面多角形で囲まれている立体。四面体・五面体など。
タモウサク	同じ田畑で年に三回以上作物を育て、収穫すること。
タモクテキ	一つの物を多くの目的に使えること。
タヨウ	さまざまな種類があること。変化に富んでいること。
タヨリ	手紙。知らせ。
タライ	湯や水を入れて物を洗うのに使う平たい容器。洗面器より大型。
タラコ	スケトウダラの卵巣を塩漬けにした食品。
タリヨウ	物の量が多いさま。大量。
タル	酒・しょうゆ・漬物などを入れる木製・円筒形の容器。
タレ	しょうゆに、みりんや砂糖などを合わせた汁。
タレマク	たれ下げた幕。また、何かを書いてたれ下げる細長い布。
タレメ	目じりが下がっていること。また、その目。下がり目。
タレント	英語で才能のこと。歌・ドラマ・司会などの仕事をしている人。
タワシ	毛や糸などをたばねて作った、物をこすって洗うためのもの。
タワラ	米や炭などを入れるために、わらで編んだ入れ物。
タワー	英語で高くそびえるような建物のこと。
タン	牛・豚などの舌の肉。
タンイ	長さ・重さ・量などをはかるもとになるもの。小さなひとまとまり。
タンカ	短い詩の一つで五・七・五・七・七の十一音からできている歌。
タンカー	石油などを運ぶタンクをつけた大型の船。
タンガン	昆虫類・クモ類・多足類などにみられる簡単な構造の目。
タンキユウ	あるものを得るために探し求めること。
タンキヨリ	短い距離。
タンク	液体や気体を貯蔵する大型の容器。戦車。
タンケン	未知の地域に踏み入り、実地に調べること。
タンコウ	石炭を採掘する鉱山。
タンゴ	文を組み立てている一つ一つの言葉。
タンサ	さぐり調べること。
タンサン	二酸化炭素を水に溶かしたもの。
タンザク	字を書いたり、しるしとして物に貼り付けたりする細長い紙。
タンシ	電気機器の回路を外部と接続するための金具。
タンシヤ	エンジンのついた二輪車。オートバイ、スクーターなど。
タンシユク	日数や時間などを短くちぢめること。
タンジユン	物事が簡単でこみいっていないこと。
タンジヨウ	人が生まれること。出生。新しく物が出来上がること。
タンス	引き出しや戸のある木の箱で、衣服や小道具をしまっておく家具。
タンスイ	塩分をほとんど含まない水。
タンソ	石炭やダイヤモンドをつくっている元素。
タンチ	隠れているものなどをさぐって様子を知ること。
タンチヨウ	変化が少なく、調子が単純なさま。
タンテイ	人の秘密や事件などを、こっそりさぐったり調べたりすること。
タントウ	受け持つこと。
タンドク	ただ一人であること。ただ一つであること。
タンペン	詩歌・小説・映画などで、比較的短い作品。
タンボ	水をはって稲を育てる所。
タンポポ	野原などに黄色や白色の花を咲かせる草花。種にはふわふわした毛がある。
タンラク	電気回路のショート。
タンレン	きびしい修行や練習を重ねて心身や技芸をきたえること。
ターゲツト	標的。まと。商品などを売り込む対象。
ターブル	長い脚の付いた平らな机。
ターン	向きを変えること。折り返すこと。
ダイ	物を乗せたり人が乗ったりする平たい物。「踏み○○」
ダイエツト	食事の量や種類を制限すること。
ダイガク	高等学校を卒業してから入る学校。
ダイキチ	運勢が非常によいこと。きわめて縁起のよい日。
ダイキボ	規模が大きいこと。
ダイキヨウ	運勢が非常に悪いこと。
ダイク	材木を使って家を建てたり、直したりする人。
ダイケイ	一組の対辺が平行な四辺形。
ダイコウ	職務などを、本人に代わって行う人。また、その人。
ダイコン	根っこが太くて長い、畑で作られる野菜。下手な役者のこと。
ダイザイ	創作・研究などの主題を展開するための材料。
ダイシゼン	広大な自然。偉大な自然。
ダイシヨウ	大きいことや小さいこと。大きさ。
ダイジン	国務大臣のこと。
ダイズ	納豆・豆腐・枝豆の材料となる、比較的大きな豆。
ダイソツ	大学を卒業していること。また、その人。
ダイタン	物事を恐れず、思い切ってするさま。
ダイダ	野球で、その打順の選手に代わって控えの選手が打者になること。ピンチヒッター。
ダイチ	広大な土地。天に対する地上のこと。
ダイドコロ	食事の用意をする所。キッチン。
ダイノウ	脳の主要部分で、神経系全体をつかさどる中枢器官。
ダイバー	潜水をする人。
ダイヒツ	本人に代わって手紙・文書などを書くこと。また、その書かれたもの。代書。
ダイヒヨウ	みんなに代わって考えを述べたり、行動すること。
ダイフク	薄くのばしたもちの皮であんを包み込んだ和菓子。
ダイブツ	巨大な仏像。
ダイブブン	全体のほとんどの部分。大半。おおかた。
ダイホン	映画・演劇・放送などで、演出の基本となるせりふ・ト書きなどを書き記した本。脚本。
ダイメイ	書物・作品などの表題。タイトル。
ダイヨウ	あるものの代わりに別のものを間に合わせに使うこと。
ダイリ	本人に代わって物事を処理すること。また、その人。
ダエン	円をおしつぶしたような形。
ダカイ	行き詰った状態を切り開いて解決に導くこと。
ダガシ	安価な雑穀や粗糖を材料にした庶民的な菓子。
ダガツキ	たたいて音を出す楽器。
ダキユウ	野球・ゴルフなどで、打った球。
ダキヨウ	利害や意見が対立しているとき、互いにゆずりあっておだやかに決着をつけること。
ダコウ	道・川・進み方などが、ヘビがはうように曲がりくねっていること。
ダシ	かつおぶしやこんぶなどを煮て出した、いい味のしる。
ダシイレ	出したり入れたりすること。
ダシモノ	芝居・演劇などで、上演する題目。演目。
ダシヤ	野球・クリケットなどで、投球を打つ人。バッター。
ダジユン	野球などで、打者の順番。
ダチヨウ	アフリカの草原地帯にすむ、空を飛べない大型の鳥。
ダツカイ	属している会から抜けること。退会。
ダツキヤク	よくないものを捨て去ること。よくない状態から抜け出ること。
ダツキユウ	骨の関節がはずれること。
ダツシメン	不純物や脂肪分を取り除いて消毒した綿。吸収性がよく、医療に使用する。
ダツシユウ	においを取り除くこと。
ダツシユツ	危険な場所などから抜け出すこと。
ダツシヨク	その物に含まれている色素や染め色を抜き取ること。
ダツスイ	その物に含まれている水分を抜き去ること。
ダツセン	列車・電車などの車輪がレールから外れること。
ダツソウ	閉じ込められている場所から抜け出してにげること。
ダツピ	ヘビなどが成長するにつれて、古い皮をぬぐこと。
ダツリヨク	体の力がぬけること。
ダトウ	相手を打ち倒すこと。打ち負かすこと。
ダハ	打ち破ること。
ダマ	粉を水で溶いたとき、完全に溶けないためにできる小さなかたまり。
ダム	発電・灌漑（かんがい）・治水などを目的に、河川の水をせき止めて貯水するための構造物。
ダリツ	野球で、打数に対する安打数の比率。
ダルマ	中国禅宗の始祖、達磨大師の座禅姿をまねて作った張り子のおもちゃ。丸い形のもの。「雪○○○」
ダレ	名前を知らない人、その人とはっきりわからない人を指す言葉。
ダンイン	団を構成している人。
ダンカイ	物事が進行・変化していく過程のひとくぎり。
ダンケツ	多くの人々が力を合わせて事にあたること。皆で一致協力すること。
ダンゲン	きっぱりと言い切ること。
ダンゴ	米や麦などの粉をこねて丸めて作った食べ物。
ダンサー	踊る人。舞踏家。
ダンシ	男の子。男児。
ダンジ	男の子。男子。
ダンジキ	一定期間自発的に食を断つこと。
ダンジヨ	男と女。
ダンス	踊り。舞踊。
ダンスイ	水道の水が出なくなること。
ダンセイ	男の人。
ダンソウ	女性が男性の姿・形に身をよそおうこと。
ダンゾク	物事が時々とぎれながらも続くこと。
ダンタイ	同じ目的を持った、二人以上の人たちの集まり。
ダンチ	住宅や工場などが計画的に建設されている地区。また、その建物。
ダンチヨウ	団の長。
ダンテイ	はっきりと判断を下すこと。
ダントウ	例年よりも暖かい冬。
ダンナ	妻が他人に対して自分の夫をいう言葉。また、他人の夫をいう言葉。
ダンネツ	熱が伝わるのをさえぎること。
ダンボウ	屋内・室内をあたためること。また、その装置。
ダンボール	波状のボール紙の片面または両面に平らなボール紙を貼り付けた板紙。
ダンメン	物体を切断した切り口の面。
ダンユウ	男性の俳優。
ダンラク	文章の中での内容の切れ目。文のまとまり。
ダンリユウ	暖かい水の流れ。周囲よりも水温の高い海流。
ダンリヨク	加えられた力に逆らって、もとにもどろうとする力。
ダンロ	火を燃やして室内をあたためる炉。
チアン	平和でおだやかなこと。「○○○が悪い」
チイ	社会やある組織の中で占めている立場。身分。
チイキ	ある区切られた土地の範囲。
チエ	どうすればいいかを考え、物事をうまくやっていく頭のはたらき。
チエス	64区画に区切った盤上に並べた白・黒16個ずつのコマを交互に動かし、相手のキングを詰めるゲーム。
チエリー	さくらんぼ。
チエンジ	英語で変化のこと。入れ替えること。取り替えること。
チエーン	くさり。
チカ	地面の下。
チカイ	約束の言葉。将来のことを強く決意すること。
チカゴロ	今、または今からあまりはなれていない過ぎ去ったときを表す。最近。このごろ。
チカシゲン	地下に埋蔵されている有用鉱物などの資源。
チカシツ	建物で、地面より下に作られた部屋。
チカスイ	地下にあって、砂・岩石などのすきまを満たして存在する水。
チカテツ	線路の全部または大部分が地下に敷設された鉄道。
チカドウ	地下に設けられた通路・道路。
チカミチ	他の道より距離が短く、目的地まで早く行ける道。また、その道を通っていくこと。
チカラ	何かを動かそうとするはたらき。相手を支配する強いはたらき。才能や能力。
チカラコブ	腕の筋肉のもりあがってできるこぶ。
チカラモチ	力の強いこと。また、その人。
チキユウ	私たちが生活している星。
チキユウギ	地球の模型。
チキン	英語で鶏肉のこと。
チギヨ	卵からかえって間のない魚。
チクセキ	たくさんたくわえること。また、たまること。
チクデンチ	充電によって繰り返し使うことのできる電池。バッテリー。
チクワ	すりつぶした魚の身を棒に付けて、焼いたりむしたりした食べ物。
チケイ	土地の形。
チシキ	物事について正しく知り、理解すること。ある事について知っている内容。学識。
チシキジン	知識・教養がある人。インテリ。
チシツ	地殻を構成している岩石・地層などの種類や性質。また、その状態。
チジ	都道府県の行政を統括・代表する長。
チジキ	地球がもっている磁石としての性質。また、それによって生じる磁場。
チジク	地球の南北両極を直線で結ぶ自転軸。
チジヨウ	土地の上。地面より上。
チジン	知り合い。知っている人。
チスジ	血のつながり。
チズ	地球の表面の一部または全部を一定の割合で縮尺し、平面上に表した図。
チセイ	物事を考えたり、見きわめたりする能力。知能。
チソウ	岩石のかけら、土砂・化石などが積み重なってできた地下の層。
チチ	おとうさん。
チチウエ	自分または他人の父の敬称。
チチオヤ	男親。
チチユウ	土の中。地面の下。
チツジヨ	物事を行う上での正しい順序。社会・集団を正しい状態に保つための順序や決まり。
チツソ	空気中の五分の四をしめている気体。
チテイ	大地の底。地下の深い場所。
チトセアメ	七五三などの縁起物として売られる、紅白の細長いあめ。
チドウセツ	地球が太陽の周りを回っているとする説。
チノウ	物事を理解し判断する頭の働き。知的な能力。
チビ	背の低いこと。また、その人。
チヘイセン	広野などで、大地と空の境界としてほぼ水平に見える線。
チホウ	首都などの大都市以外の地域。国内のある一定の地域。
チヤイロ	黒みがかかった赤黄色。
チヤガシ	茶を飲むときに食べる菓子。茶の子。
チヤキ	茶の湯に使う道具類。茶道具。
チヤクガン	大事な点に目をつけること。目のつけどころ。
チヤクシユ	ある仕事にとりかかること。
チヤクシン	通信が到着すること。また、その通信。
チヤクセキ	席に着くこと。いすなどにすわること。
チヤクチ	地面・床面に降り立つこと。
チヤクモク	重要なものとして目をつけること。特に注意して見ること。着眼。
チヤクリク	飛行機などが空中から地上に降りること。
チヤツカ	火がつくこと。また、火をつけること。
チヤツミ	茶に加工するために、茶の木の若芽や若葉をつみとること。また、その人。
チヤヅケ	熱いお茶をかけて食べるご飯。
チヤヅツ	茶の葉を入れておく円筒形の容器。
チヤドウグ	茶の湯に用いる道具。茶器。
チヤドコロ	良質の茶を多く生産する土地。
チヤノマ	食事をしたり、くつろいだりするための部屋。
チヤバシラ	茶を入れたとき、茶碗の中に縦になって浮く茶の茎。
チヤワン	お茶を飲んだり、ご飯を食べたりするときに使ううつわ。
チヤンコ	相撲部屋独特の鍋料理。大量の魚介・肉・野菜を大なべで煮ながら食べるもの。
チヤンス	英語で好機・機会のこと。
チヤンネル	テレビやラジオで放送局に割り当てられた電波の周波数。
チヤーハン	米飯を焼き、エビ・ネギ・卵などの具とともにいため、醤油などで味をつけたもの。焼き飯。
チユ	病気・けがなどが治ること。
チユウ	空。空間。
チユウイ	心をそのことにしっかり向けて、気を付けること。用心。気をつけるように言うこと。
チユウオウ	真ん中。中心となる位置。センター。首都。政府。
チユウカイ	双方の間に立って物事をまとめること。また、その役。なかだち。
チユウカク	物事の核心となる重要な部分。
チユウケイ	あるものをとちゅうで受け継いで、渡すこと。
チユウコ	一度使って古くなった物。
チユウゴク	アジア東部の社会主義の巨大な国。
チユウゴシ	腰を半ばあげて立ちかかった姿勢。
チユウシ	前もって予定していたことを取りやめること。
チユウシヤ	ひふにさした、穴のあいた針を通して、薬などを体内に入れること。
チユウスイ	水をそそぎ入れること。水をそそぎかけること。
チユウセイ	歴史の時代区分の一つ。古代と近代との間の時代で、封建制を基礎とする。
チユウヅリ	空中にぶら下がっていること。
チユウテン	数学で、一つの線分または有限曲線を二分する点。
チユウトウ	ヨーロッパから見て東方の地のうち、極東と近東の中間の地域。
チユウトロ	マグロの肉で、脂肪分のやや多いもの。
チユウネン	青年と老年の間の年頃。四十代から五十代後半までの人。
チユウビ	強火と弱火の間の、中ぐらいの火の強さ。
チユウボウ	台所。調理場。くりや。
チユウモク	注意してみること。また、関心をもって見守ること。
チユウヤ	昼と夜。
チユウユ	機械などに油をさすこと。
チユウリツ	どちらの味方もしないこと。
チヨウ	羽が大きく、色や模様が美しい昆虫の一種。
チヨウイン	条約・協定などの公文書に双方の代表者が署名・捺印すること。
チヨウカク	音波刺激を認知する感覚。
チヨウカン	朝に発行される新聞。
チヨウキ	長い期間。長期間。
チヨウケシ	金銭などの賃借関係が消滅すること。
チヨウコウ	物事が起こる前ぶれ。きざし。
チヨウコク	木や石などをほって刻んで、形を作ること。ほってつくった作品。
チヨウゴウ	薬などを決められた分量どおりに混ぜ合わせること。
チヨウサ	物事を確かめるため、いろいろ調べること。
チヨウシ	人の健康の状態。機械の動き方の様子。音律の高低。
チヨウシヨ	とくにすぐれている点。とりえ。
チヨウジユ	寿命が長いこと。長生きすること。長命。
チヨウジヨ	女で最初に生まれた子。
チヨウジン	並外れた能力を持つ人。スーパーマン。
チヨウセイ	調子の悪さ、物の不足などを整え直して、ほどよくすること。調節。
チヨウセツ	ほどよく整えること。調整。
チヨウセン	アジア東部の半島。
チヨウソン	町と村。
チヨウチン	中にろうそくをともす照明具の一種。
チヨウテイ	対立している両者の間に入り、争いをやめさせること。
チヨウテン	一番高い地点。てっぺん。
チヨウナイ	町の中。
チヨウナン	男で最初に生まれた子。
チヨウハツ	かみの毛を長くのばすこと。
チヨウブン	長い文章。
チヨウヘイ	国家が法律に基づいて国民を徴集し、一定期間兵役につかせること。
チヨウボ	金銭・物品の出納など、事務上の必要事項を記録する帳面。
チヨウミ	飲食物に味をつけること。「○○○○料」
チヨウミン	町の住民。
チヨウヤク	とびはねること。とび上がること。ジャンプ。
チヨウリ	料理をすること。
チヨウルイ	鳥の仲間。
チヨウレイ	学校・会社などで朝、始業前に全員が集まってあいさつや連絡を行う行事。
チヨウワ	二つ以上の別々のもののつり合いが、よくとれていること。
チヨキン	お金をためること。
チヨクゴ	物事の起こったすぐ後。
チヨクシ	目をそらさずに、じっと見ること。事実をありのままに見ること。
チヨクシン	まっすぐ進むこと。ためらわずに進むこと。
チヨクセツ	間に他の物をはさまないで、じかに接すること。
チヨクセン	まっすぐな線。
チヨクゼン	物事の起こる寸前。
チヨクソウ	直接相手に送ること。
チヨクツウ	乗り換えや中継なしに、直接目的地や相手に通じること。
チヨクメン	物事に直接対すること。
チヨクヤク	外国語の文章を、その語句・語法に従って忠実に翻訳すること。逐語訳。
チヨクリツ	まっすぐに立つこと。高くそびえること。
チヨサク	書物などを書きあらわすこと。また、その物。
チヨシヤ	その書物を書きあらわした人。著作者。
チヨシヨ	その人が書きあらわした書物。著作。
チヨスイチ	上水道・発電・灌漑（かんがい）などに用いる水をためておく人工の池。
チヨゾウ	物をたくわえておくこと。
チヨチク	金品をたくわえること。また、その金品。
チヨツカク	九十度の角度。
チヨツカン	くわしく考えないで、物事をすぐに感じ取ること。
チヨツケイ	円または球の中心を通り、その両端が円周上または球面上にある線分。
チヨツケツ	二つの物事が直接に結びついていること。また、直接に結びつけること。
チヨビヒゲ	鼻の下にほんの少し生やしたひげ。
チヨメイ	世間によく名前が知られていること。
チラシ	広告・宣伝文を印刷した紙。
チラシズシ	すし飯の上に各種のすし種を彩りよく並べたもの。ちらし。
チリヨウ	病気やけがを治すこと。
チンアゲ	賃金の額を引き上げること。
チンカ	火事が消えること。火事を消すこと。
チンキヤク	めったに来ない、めずらしい客。
チンギン	労働の対価として労働者に支払われる金銭。
チンサゲ	賃金の額を引き下げること。
チンシヤ	事情などを述べてあやまること。
チンジ	めったに起こらない、めずらしい出来事。
チンジヨウ	目上の人に実情を述べること。特に、官公庁や政治家に事情を述べて善処を求めること。
チンセイ	騒ぎや興奮した気持ちなどを、しずめ落ち着かせること。しずまり落ち着くこと。「○○○○剤」
チンタイ	料金を取って物を貸すこと。賃貸し。
チンデン	液体の中の解けない物が下に沈んでたまること。
チンボツ	水の中にしずむこと。
チンモク	だまりこんで口をきかないこと。
チンレツ	人々に見せるために物品を並べておくこと。
チーズ	牛乳などを発酵させて固めた食べ物。
チーム	同じ仕事やスポーツをするための組や団体。
ツアー	いろいろな所をまわる観光旅行。
ツイカ	後から付け加えること。
ツイキ	後から書き加えること。また、その文章。
ツイキユウ	悪事や責任を探って、どこまでも追いつめること。
ツイシ	「追試験」の略。
ツイシケン	定期試験を受けなかった人や不合格者に対して、後で特別に行う試験。追試。
ツイシン	手紙で、本文を書き終えた後でさらに書き加える文。また、その初めに記す言葉。追って書き。
ツイジユウ	人の後につき従うこと。人の言動にそのまま従うこと。
ツイセキ	逃げる者の後を追いかけること。その後の経過をたどること。
ツイタチ	月の最初の日。
ツイタテ	部屋の中に立てて仕切りや目隠しにする家具。
ツイトツ	車などが後ろからぶつかること。
ツイホウ	好ましくないものを追い払うこと。しめ出すこと。
ツイラク	人や飛行機などが高い所から落ちること。
ツウイン	治療を受けるために、病院・医院などに通うこと。
ツウカ	通りすぎること。試験などにパスすること。
ツウガク	児童・生徒・学生が学校に通うこと。
ツウキン	会社や工場などの勤め先に通うこと。
ツウコウ	人や車などが行ったり来たりすること。
ツウシヨウ	正式ではないが、世間一般に通用している名称。通り名。
ツウシン	電信・電話・郵便などで何かを知らせること。
ツウシンボ	児童・生徒の学業成績などを記入し、学校から家庭に通知するための書類。通知表。
ツウジヨウ	ふだん。ふつう。
ツウセツ	世間一般に広く認められている説。
ツウチ	物事を知らせること。知らせ。
ツウチヨウ	お金や数量などを記録しておく帳面。
ツウフウ	尿酸が血中に増加し、結晶となって関節や腎臓などに沈着する病気。風が当たっただけで痛むほど痛い。
ツウホウ	警察などに知らせること。知らせ。
ツウヨウ	有効なものとして使われること。適切なものとして受け入れられること。
ツウロ	通行するためにあけてある場所。通り道。
ツウワ	電話で話をすること。
ツエ	手に持って体を支える棒。たよりにするもの。
ツカイカタ	使用する方法。
ツカイステ	使い終えたら捨てること。使い終えたら捨てるように作られているもの。
ツカイミチ	使う用途。
ツカイモノ	使って役に立つもの。
ツカレ	疲れること。
ツガイ	動物の雄と雌の一対。
ツキ	地球の周りを約一ヶ月で回っている衛星。
ツキアイ	人と交わること。交際。
ツキアカリ	月の光。また、月の光で明るいこと。
ツキアタリ	通路の行き詰った所。
ツキギメ	一か月を単位として契約すること。
ツキソイ	世話をするためにそばについていること。また、その人。
ツキヒ	月と日。
ツキミ	月を眺めて楽しむこと。
ツキユビ	指先に強く物が当たるなどして、指の関節や腱（けん）を痛めること。
ツキヨ	月が明るく照る夜。
ツギ	時間的・空間的にすぐ後に続くこと。順序・地位がすぐそれに次ぐこと。すぐ後。
ツギキ	植物の芽や枝をとって同種または近縁の植物に接ぐこと、
ツクエ	本を読んだり、物を書いたりするための平らな台。
ツクシ	早春にスギナの地下茎から出る胞子茎。
ツクダニ	小魚・貝・海藻などを醤油・砂糖・水あめなどで味濃く煮つめた食品。
ツクリ	漢字の構成部位の名称。左右の組み合わせからなる漢字の右側に付くもの。
ツケアワセ	主となる料理に添えて出すもの。
ツケモノ	野菜などを塩・酢・味噌・醤油・こうじ・酒かすなどに漬け込んだ貯蔵食品。
ツケヤキバ	にわか仕込みで知識や技術などを身につけること。また、その知識や技術。
ツゴウ	その折の状況や事情。
ツタエ	言葉で伝えること。また、その内容。伝言。「言い○○○」
ツチ	岩や石がこわれて、長い間に細かく変化したもの。地。
ツチフマズ	足の裏のくぼんだところ。
ツチヘン	「地」「坂」「塩」などの漢字の左側の部首。
ツツ	細長い棒状で断面が丸く、中が空になっているもの。
ツツカケ	つま先にひっかけるようにしてはく簡単なはき物。サンダルの類。
ツツコミ	突っ込むこと。漫才で中心になって話を進める役。
ツツミ	外側を包んでいるもの。包んだもの。
ツヅキ	続いている後の部分。
ツヅリ	つづること。アルファベットで単語を表記するときの文字の並び。スペル。
ツトメ	会社や役所の仕事。しなければならないこと。
ツトメサキ	勤務している所。勤務先。
ツドイ	集まり。また、集まって行う催し物。
ツナ	繊維・針金などを長くより合わせた物。ロープ。
ツナガリ	つながること。関係。
ツナヒキ	二つに分かれて一本のつなを引き合って勝負を競う競技。
ツナミ	大きな高波が海岸におしよせて来る現象。
ツナワタリ	空中に一本の綱を張り、その上を渡ること。
ツノ	動物の頭にある、固くつき出たもの。
ツバ	唾液。つばき。
ツバサ	鳥の前足が変化した、空を飛ぶための器官。
ツバメ	小鳥の一種。春、南方から来て秋に変える渡り鳥。身軽で速い。
ツブ	形が丸くて小さい物。
ツボ	口が小さく、胴の部分がふくらんでいる入れ物。
ツボミ	花びらが閉じていて、これから咲こうとする花。
ツマ	結婚した男女のうち、女の人を言う言葉。
ツマサキ	足の指の先。
ツマミ	つまむところ。つまむこと。簡単な酒のさかな。
ツマミグイ	はしなどを使わないで、指先でつかんで食べること。
ツマヨウジ	歯にはさまった食べ物をつついて取り除く細くて小さな棒。
ツミキ	材木を積み上げること。木片を積んでいろいろな形を作る遊び。また、そのような木片のおもちゃ。
ツミレ	魚のすり身に卵・小麦粉などのつなぎと調味料を入れてこね合わせ、少しずつ丸めて熱湯でゆでた食べ物。
ツムジ	頭の、毛がうずまき状に生えているところ。
ツメ	動物の指の先にある、かたいもの。
ツメキリ	つめの先を切る道具
ツメミガキ	つめをみがくこと。また、つめをみがく道具。
ツヤ	物のなめらかな表面から出てくる光。
ツユ	初夏の長雨。または、そのじめじめした季節。
ツユイリ	梅雨が始まること。また、その日。
ツヨガリ	本当は強くないのに、強そうなふりをすること。
ツヨキ	気の強いこと。賭け事や勝負で、一気に勝とうとすること。
ツヨビ	火力の強い火。
ツヨミ	強いところ。優位に立つ点。強さ。
ツララ	雨や雪のしずくが凍って、軒先などから棒状に垂れ下がったもの。たるひ。
ツリ	魚をつること。
ツリイト	魚を釣るのに用いる糸。
ツリザオ	魚を釣るのに用いるさお。
ツリセン	代価以上の貨幣で支払われたとき、支払った人に戻す差額の金銭。つり。
ツリバシ	橋脚（きょうきゃく）を使わず、両岸から張り渡したケーブルや綱でつり下げた橋。
ツリバリ	魚釣りに使う先のとがった針。
ツリブネ	魚釣りに用いる船。魚釣りをしている船。
ツリボリ	池などに魚を飼っておき、料金を取って釣らせる所。
ツリワ	体操用具の一つ。上からつり下げた二本のロープの先に手でにぎるための輪をつけたもの。
ツル	植物の茎が長く伸びて、地面をはったり他の物に巻きついたりしているもの。
ツルギ	両方に刃がある刀。また、刀剣の総称。
ツレ	一緒に行くこと。また、その人。同伴者。
ツワリ	妊娠初期の女性にあらわれる食欲不振・吐き気・嘔吐・嗜好の変化などの症状。
テアカ	手のあか。手で何度もさわったためについた汚れ。
テアシ	手と足。
テアテ	病気やけがを治すためにする処置。はたらいたことに対して払われるお金。
テアライ	手を洗うこと。また、それに用いる器。便所。
テイアン	話し合いや会議に考えや議案を出すこと。
テイエン	計画的に樹木・泉水・築山などを配置した庭。
テイオン	低い声や音。
テイカ	低くなること。下がること。
テイガク	一定の金額。決まった額。
テイキアツ	大気中で、周囲よりも気圧の低い領域。
テイキヨウ	他人の役に立てるために、自分の持つ金品や技能などを与えたり使用させたりすること。
テイクウ	空中の低い所。地表面・水面に比較的近い空間。
テイコウ	外からの力に対し、負けないようにがんばること。反抗。
テイコク	定められた時刻。定時。
テイシ	途中で止まること。途中で止めること。
テイシヤ	車が止まること。車を止めること。
テイシユ	一家のあるじ。主人。また、宿屋・茶屋などのあるじ。夫。
テイシユツ	書類・資料などを差し出すこと。
テイシヨウ	新しい考えなどを示して広く人々に呼びかけること。
テイシヨク	食堂・料理店などで、あらかじめ料理の組み合わせが決まっている食事。
テイジセイ	学校教育で、夜間などの特定の時間・時期に授業を行う課程。
テイジユウ	ある場所に住居を定めて生活すること。
テイスウ	あらかじめ決められた一定の数。
テイセイ	まちがいを正しく直すこと。
テイセツ	一般に正しいと認められている説。
テイソ	裁判所などに訴え出ること。訴訟を起こすこと。
テイソク	速度が遅いこと。
テイタク	広くて立派な家。屋敷。
テイチアミ	移動する魚群を誘い込んで捕獲するために、沿岸の一定海域に敷設しておく網。
テイチヤク	あるものがしっかりと付いて動かないこと。
テイデン	送電が止まること。
テイド	物事の大小・高低などの量。どれほどのものか。大体そのぐらい。
テイネイ	相手のことを思いやって心をこめて親切にする様子。細かい点までよく気を付けて、心をこめてするさま。
テイバン	流行にかかわりなく常に一定の売上げが期待できる基本的な商品。
テイヒヨウ	広く世間に認められ、しっかりと定まっている評判・評価。
テイヘン	三角形で底にある辺。
テイボウ	水があふれるのを防ぐために、川岸や海岸に土や石を積み上げたり、コンクリートで固めたりして作った土手。
テイメイ	雲などが低い所をただようこと。好ましくない状態が続いていること。
テイメン	底の面。
テイリ	定義・公理によって真であることが証明されている命題。
テイレ	よい状態を保つために補修・整備などの手を加えること。
テイレイ	決まった月日・日時に行われること。定期的に行われること。
テウチ	うどん・そばなどを、機械を使わずに手で打って作ること。
テカガミ	手に持って使う、柄のついた鏡。
テカゲン	手にとった感じで物の重さ・分量・程度などをはかること。
テガカリ	きっかけ。糸口。
テガキ	手で文字などをかくこと。
テガミ	だれかに伝えたい事がらを書いて送る文書。たより。
テガラ	人からほめられるような目覚しい動き。功績。
テキオウ	周囲の状況・条件などによく合うこと。また、よく合うように行動や考え方を変えること。
テキカク	的をはずさないで、たしかであること。まちがいないこと。
テキゴウ	条件・状況などにぴたりと当てはまること。
テキセイ	適切で正しいこと。
テキセツ	その時、その場合にちょうど当てはまるさま。
テキトウ	ちょうどよく当てはまる様子。分量などがちょうどいいさま。いいかげんなさま。
テキド	程度がちょうどよいこと。
テキニン	その任務・仕事などに適していること。
テキヨウ	法律・規則・方法などを個々の事例に当てはめて用いること。
テキリヨウ	適当な分量。
テギワ	物事を処理するやり方。また、物事を処理する手腕・技量。
テクビ	腕と手のひらがつながる関節の部分。
テコ	小さな力を大きな力に変えて重い物を動かす棒やしかけ。
テゴタエ	何かをした瞬間に手に受ける感じ。
テサグリ	見えない所を手先の感じでさぐること。模索しながら物事をすすめること。
テサゲ	手にさげて持つように作った袋・かご・かばんなどの類。
テサバキ	手で物を扱うときの、手の使い方や動かし方。
テザワリ	手にさわったときの感じ。
テシゴト	手先を使ってする仕事。
テシタ	ある人の下にあって、命令・指図されるままに働く人。配下。
テジナ	不思議なことをやってみせる芸。マジック。
テジユン	仕事をする順序。
テジヨウ	手首にはめてかぎをかけ、腕の自由を奪う鉄製または革製の輪。
テスト	英語で試験や検査のこと。
テスリ	人がつかまるように橋・階段・ベランダなどのふちに取り付けた柵。また、柵の上に渡した横木。
テソウ	その人の運勢を表しているとされる、手のひらの筋や肉付きなどの様子。
テダシ	手を出すこと。争いをしかけること。
テダスケ	人の仕事などを手伝って助けること。また、手伝いとして役に立つこと。
テチガイ	物事の手順や手続きを間違えること。段取りを誤ること。
テチヨウ	いつも携帯して、心覚えを記しておくための小形の帳面。
テツ	金属元素の一つ。元素記号Ｆｅ。かたくて銀色のつやを持つ。
テツカズ	まだ手をつけていないこと。まだ使わないで、そのまま残っていること。
テツガク	人生や世界、事物のあり方などを深く考えて求めようとする学問。
テツキ	物事を行うときの手の動かし方。
テツキヨウ	鉄鋼材でつくった橋。特に、鉄道用の橋。
テツコツ	建造物の骨組みに使う鉄材。
テツザイ	土木・建築・工作加工などに用いる鉄製の材料。
テツソク	変えることのできないきびしい規則・法則。
テツダイ	手伝うこと。また、その人。
テツヅキ	物事を行う順序や方法。一定の順序や形式に従った処理。
テツテイ	命令・方針などがすみずみまで行き渡ること。
テツドウ	上を電車や汽車などを走らせ、人や荷物を運ぶためのレール。
テツパイ	それまで続いてきた制度・規則などを取りやめること。
テツパン	鉄製の板。
テツブン	物質に含まれる成分としての鉄。
テツボウ	鉄製の棒。かなぼう。
テツヤ	一晩中、眠らないこと。夜通し。
テヅカミ	道具を使わずに手で直接つかむこと。
テヅクリ	自分の手で作ること。自分で作った物。
テヅマリ	とるべき手段・方法が尽きて困ること。
テナオシ	一通り出来上がった後で、不完全な部分を直すこと。
テナミ	腕前。技量。「お○○○拝見」
テニス	中央にネットを張ったコートの両側に競技者が向かい合い、ラケットでボールを打ち合って得点を競う球技。
テニモツ	手で持ち運ぶ荷物。
テヌグイ	手・顔・体などをふくための長方形の布。
テノコウ	手をにぎったとき、外側になる面。
テノヒラ	手をにぎったとき、内側になる面。
テハジメ	物事を始める最初の段階。物事のしはじめ。
テバサキ	鶏肉で、手羽の先の方の部分。
テビキ	人の手を引いて導くこと。人を案内すること。情報を教えるなどして手助けすること。ガイド。
テビヨウシ	手をたたいて拍子をとること。
テブクロ	寒さやけが、汚れなどから手を守るために、手にはめる物。
テブラ	手に何も持たないこと。
テヘン	「打」「持」「指」などの漢字の左側の部首。
テホン	文字や絵を習うとき、模範とするもの。見習うべき人や物事。模範。
テマ	仕事を仕上げるのに必要な時間や手数。
テマエ	自分のすぐ前。ある所よりも自分に近い方。
テマエミソ	自分のことをほめること。自慢。
テマキ	手で巻くこと。手で巻いて作ること。また、そのもの。
テマネキ	こちらに来るようにと、手先を上下に動かして合図をすること。
テマヒマ	労力と時間。
テマリ	手でついて遊ぶためのまり。
テマワシ	器具・機械などを手で回すこと。
テミヤゲ	人を訪問する際に持っていく、ちょっとしたみやげ。
テモチ	今手元に持っていること。現に所有していること。
テモト	自分の手の近く。
テラ	仏像をまつり、坊さんが修行したり、仏事を行う所。
テリカエシ	光や熱を反射すること。また、その熱や光。
テリヨウリ	自分の手で作った料理。
テレカクシ	はずかしさをかくそうとすること。
テレビ	映像を電波にして送り、それを遠く離れた所に映し出す装置。
テレホン	電話。電話機。テレフォン。
テレヤ	すぐに照れる人。はにかみや。
テン	空の上。
テンイン	店にやとわれて働いている人。
テンカ	火をつけること。
テンカイ	大きく広げること。広がること。物事を繰り広げること。
テンガン	目に目薬をたらすこと。
テンキ	晴れ・くもり・雨などの気象の様子。
テンキヨ	住居を別に移すこと。引っ越し。
テンケイ	同種・同類のものの中で、その特性を最もよく表しているもの。
テンケン	悪いところがないか、一つ一つ調べること。
テンコ	一人ひとりの名を呼んで、全員がそろっているかどうかを確かめること。
テンコウ	空の状態。天気。
テンコモリ	食べ物を食器にうずたかく盛ること。山盛り。
テンゴク	神がいるという、平和で楽しい理想の世界。
テンサイ	生まれつき、すぐれた才能を持っていること。
テンサク	他人の詩文・答案などを、字句を書き加えたり削ったりして直すこと。
テンザイ	あちこちに点々と散らばって存在すること。
テンシ	神の使者として人間界につかわされ、神と人の仲介をつとめるもの。エンジェル。
テンシヨク	別の職業に変わること。転業。
テンジ	物品、特に作品や研究資料などを並べて多くの人が見られるようにすること。
テンジヨウ	部屋の上をおおうもの。
テンスウ	得点の数。
テンセン	たくさんの点が連らってできている線。
テンチ	天と地。空と地面。
テンテキ	自然界で、ある生物の捕食者・寄生生物となってその繁殖をはばむ他の生物。
テント	雨や日光をさえぎるための、布でできた幕。
テントウ	転んでひっくり返ること。物事の上下や順序などが逆さまになること。
テンドン	どんぶりに盛った米飯の上に天ぷらを乗せ、濃いつゆをかけたもの。
テンネン	人の手の加わらない、自然のままであること。
テンノウ	今の憲法で国民の象徴としてあおがれる人。
テンビヨウ	絵画で、点または点に近い短い線を連ねて事物を描くこと。また、その画法。「○○○○○法」
テンビン	中央を支点とするてこを利用したはかり。
テンプラ	食べ物に小麦粉などの衣を付けて油であげる食べ物。
テンボウ	遠くまで広く見渡すこと。また、その眺め。
テンポ	音楽の曲の速さ。
テンメイ	天の命令。天から与えられた使命。天から授けられた寿命。
テンメツ	明かりがついたり消えたりすること。
テンモン	天体とその周辺に起こる諸現象。
テンヨウ	本来の目的とは異なる別の用途に当てること。
テープ	紙やビニールなどで作った、はばのせまい長い帯のようなもの。
デアイ	出会うこと。めぐり合い。
デイスク	円盤。円板。
デイリ	出たり入ったりすること。
デイリグチ	人の出入りする所。
デカセギ	一定期間、家や故郷を離れ、よその土地や国へ行って働くこと。
デキ	できあがった物の状態。できぐあい。できばえ。
デキアガリ	物ができあがること。完成。
デキゴト	世の中で起こった事がら、事件。
デキタテ	出来上がったばかり。
デグチ	中から外へ出るための口。
デコボコ	物の表面に出っぱった所やへこんだ所があること。おうとつ。
デシ	先生について、教えを受ける人。
デシイリ	弟子になること。
デダシ	物事の始まり。すべり出し。始まりの部分。
デハイリ	出ることと入ること。でいり。
デバン	勤め・舞台などに出る番。その人が出て活躍すべき場面。
デパート	いろいろな品物を売っている大きな店。百貨店。
デビユー	フランス語で歌手・俳優・作家などが広く世の中に出てくること。
デマエ	店の人が注文のあった料理を届けること。
デマド	外壁面より外側に張り出している窓。
デムカエ	出て行って迎えること。また、その人。
デメキン	両眼が大きく突き出ている金魚。
デンアツ	電気が流れる強さ。
デンキ	電子の動きによって起こる現象。または、そのエネルギー。電灯。
デンキユウ	電気が流れると、光を発する球。
デンゲキ	強い電流が体に流れたときに感じる衝撃。いなずまのように衝撃を与えること。
デンゲン	電力を供給するみなもと。電流を取り入れるみなもと。コンセント。
デンゴン	人を介して先方に用件を伝えること。また、その言葉。ことづけ。ことづて。
デンシヤ	レールの上を電気の力で走り、人や荷物を運ぶ車。
デンシヨウ	古くからの行事・風習・言い伝えなどを受け継いで次代に伝えていくこと。
デンジ	電気と磁気。また、その相互作用。
デンジキ	電気と磁気。また、その相互作用。電流によって生じる磁気。
デンジハ	電磁場の振動が波動として真空または物質中を伝わっていくもの。
デンタク	かんたんな計算ができる小型計算機。
デンタツ	命令・意思・連絡事項などを相手に伝えること。
デンチ	化学反応や太陽光などで電気を起こす装置。
デンチユウ	空中にかけわたす電線を支える柱。電信柱。
デントウ	ある集団・社会・民族の中で有形・無形の遺産として受け継がれてきた思想・技術・風習・しきたりなどの事柄。
デンドウ	電気を動力源とすること。
デンネツ	電流が抵抗体を流れるときに発生する熱。
デンパ	目に見えない電気と磁気の波。
デンプン	植物の光合成によってできる炭水化物。
デンポウ	電信によって文字や符号を送受する通信。
デンリユウ	導体を伝わる電気の流れ。
デンリヨク	電流による動力。
デンワ	声を電気信号で遠いところに送ったり、送られてきた信号を声に変えたりして、たがいに通話をする装置。
デート	男女が会うこと。また、会う約束。
トイ	わからないことをたずねること。問題。
トウアン	試験などの問題を解いて書いた答え。
トウイツ	ばらばらのものを一つにまとめること。
トウガラシ	赤い香辛料で、ナスの仲間の果実。
トウキ	焼き物のこと。
トウキユウ	ボールを投げること。
トウギユウ	牛と牛、または牛と闘牛士がたたかう競技。
トウクツ	鉱物・埋蔵物などを許可なく掘って盗み取ること。
トウケイ	ある集団の構成要素を調査して得た数値を処理し、その集団の性質や傾向などを数量的に表すこと。また、表されたもの。
トウゲ	山道を登りきった所。
トウゲイ	陶磁器を作る技芸・工芸。
トウコウ	児童・生徒・学生などが学校に行くこと。
トウゴウ	二つ以上のものをまとめ合わせて一つにすること。
トウサイ	車両・艦船・航空機などに物資を積み込むこと。また、兵器などを積んで装備すること。
トウサク	他人の作品の全部または一部をそのまま自分のものとして使うこと。また、その作品。
トウサン	経営が行き詰って企業がつぶれること。
トウザイ	東と西。東部と西部。東洋と西洋。
トウシ	利益を得る目的で資金を事業・証券などに投下すること。
トウシキ	二つの数または式を等号で結んだもの。方程式と恒等式がある。
トウシツ	糖を主成分とする物質。炭水化物。
トウシヤ	この会社。我が社。
トウシユ	打者に対してボールを投げる人。
トウシユウ	それまでのしきたりややり方を変えずに、そのまま受け継ぐこと。
トウジ	ちょうどそのころ。
トウジキ	陶器と磁器。やきもの。
トウジシヤ	その事柄に直接関係している人。
トウジツ	ちょうどその日。
トウジヨウ	舞台・演台などに現れ出ること。新しく世の中やある分野に現れ出ること。
トウセイ	国家権力などが、一定の方針に従って全体を指導し、制限を加えること。
トウセン	選挙やくじなどで選び出されること。
トウタ	環境や条件に適用した生物が子孫を残し、適用できない生物は滅びること。また、その現象。
トウタツ	目標とする地点や状態に行き着くこと。
トウダイ	夜、船の目印になるように強い光を出して、船の安全を守る設備。
トウチ	主権者がその国土・国民を支配し、治めること。
トウチヤク	目的地に着くこと。また、物が届くこと。
トウテン	意味の切れ目を示し、読みやすくするために文中に置く点。
トウド	凍った土。凍りついた大地。
トウニユウ	投げ入れること。資金・労力などをつぎ込むこと。
トウハツ	頭の毛。髪の毛。
トウバク	幕府を倒すこと。
トウバン	割り当てられた仕事の番に当たること。または、その人。
トウヒコウ	世間をのがれてあちこち移り歩いたり隠れ住んだりすること。
トウヒヨウ	選挙のとき、決められた用紙に自分が選んだ人や物の名前を書いて投票箱などに入れること。
トウビヨウ	病気を治そうとして、くじけることなく療養につとめること。
トウフ	水に浸した大豆をすりつぶして煮た汁を布でこして豆乳を作り、にがりなどを加えて凝固させた食品。
トウブ	東側の土地。
トウブン	ある物質に含まれている糖類の成分。
トウベン	質問に答えて弁明すること。また、その弁明。
トウホク	東と北の中間の方角。青森・秋田・岩手・宮城・山形・福島の六県がある地方。
トウミン	動物が土や穴の中でねむったようにして冬をこすこと。
トウメイ	透き通って見えるさま。
トウユ	灯火用の油や、暖房用燃料の油。
トウユウシ	投資と融資。
トウヨ	医師が患者に薬を与えること。投薬。
トウヨウ	西洋に対するアジア諸国の総称。アジア東部および南部の国々。
トウリツ	逆立ち。
トウルイ	野球で、塁上の走者が守備側のすきをついて次の塁に進むこと。
トウロク	帳簿に記載すること。
トウロン	互いに議論をたたかわすこと。
トエイ	東京都が経営・管理すること。
トオカ	月の十番目の日。一日の十倍。
トオボエ	犬や狼が遠くに向かってほえること。また、その声。
トオマワシ	あからさまにではなく、それとなくにおわせて言うこと。
トオマワリ	遠い方の道を通っていくこと。回り道。迂回。
トオリ	人や車の通る所。道路。人や車が通ること。ゆきき。
トオリミチ	行き来のために通る道。また、通りすがりの道。
トカイ	人口が多く、商工業や文化活動が盛んな大きな街。
トカゲ	尾が長くちぎれやすい爬虫類。四足は短いが、動きがすばやい。
トキ	過去から現在、未来へと切れ目なく一定の速さで流れていくもの。時間。
トギカイ	東京都の議決機関。
トク	もうけ。利益。
トクイ	他と比べて特に異なっていること。
トクイサキ	いつもよく品物を買ってくれる客。取引先。顧客。
トクギ	とくに自信を持っているわざや能力。
トクサク	有利な方策。得になるやり方。
トクサン	その土地や地方で特に産出すること。また、その産物。
トクシ	特別の任務を帯びた使者。特に、元首などの代理として外国に遣わされる使者。
トクシユ	性質・機能・用途・内容などが普通とは異なっていること。限られた範囲内でしか当てはまらないこと。
トクシユウ	新聞・雑誌・テレビ・ラジオなどで、ある特定の問題を取り上げて編集したり放送したりすること。また、その記事・番組など。
トクシヨウ	特別の賞。また、一等の上に設けられる最高の賞。
トクシヨク	他と比べて特に異なっている点。
トクセイ	特別に手をかけて作ること。また、その品。
トクセツ	特別に設けること。
トクソク	契約・債務などの履行や税の納付をうながすこと。
トクダイ	寸法などが特別に大きいこと。
トクダネ	新聞・雑誌の記事などで、その社だけが入手した特別の情報。スクープ。
トクチヨウ	他と比べて特に目立つ点。
トクテン	競技・試験などで、点数を得ること。また、その点数。
トクバイ	特別に安い価格で商品を売ること。
トクヒツ	そのことについて特に書き記すこと。
トクヒヨウ	選挙で候補者が票を獲得すること。また、獲得した票。
トクベツ	他とはっきり区別されること。特に、他とはっきり区別して扱うこと。
トクホウ	特別に報告・報道すること。また、その報告・報道。
トクメイ	名前をかくして出さないこと。
トクヨウ	値段の割に量などが多くて役に立つこと。
トケイ	時刻を知ったり、時間をはかったりする機械。
トゲ	バラやサボテンなどの植物のくきや葉に生えている、小さくてかたくとがった部分。
トコウ	船や航空機で海外へ行くこと。
トコズレ	長く病床にあるとき、体の床に当たる部分が血行障害を起こしてただれること。
トコナツ	一年じゅう夏のような気候であること。
トコヤ	かみの毛を切ったり、ひげをそったりする店。
トコロテン	海藻のテングサを煮て溶かし、型に流して冷やし固めた食品。
トサカ	ニワトリ・キジなどの頭部にある肉質冠状の突起物。
トザン	山に登ること。山登り。
トシ	一月一日から十二月三十一日までの期間。年齢。高齢。
トシウエ	年齢が上であること。また、その人。
トシコシ	新しい年をむかえること。
トシシタ	年齢が下であること。また、その人。
トシノコウ	年をとって経験を積んでいること。「亀の甲より○○○○○」
トシヨ	本や書物のこと。
トシヨカン	図書・記録その他の資料や情報を集めて整理・保管し、広く一般の利用に供するための施設。
トシヨシツ	多くの図書などを集めて保管し、利用者に閲覧させる部屋。
トシヨリ	年を取った人。老人。
トシワスレ	年の暮れに、一年の苦労を忘れること。また、そのために催す宴会。忘年会。
トジマリ	出入り口の戸や窓を閉め、かぎなどをかけること。
トソウ	装飾や保護のために、物の表面に塗料を塗ること。また、塗料を吹き付けること。
トダナ	前に戸があり、中に棚のある、物を入れる家具。
トチ	土。地面。
トチカン	その土地の地理・地形・事情などに通じていること。
トチガラ	その土地に特有な風俗・習慣。また、そこの住民に特有の気風。
トチユウ	目的地へ着くまでの間。物事がまだ終わらないうち。
トツカ	特別に安くつけた値段。
トツキ	物の一部分が突き出ていること。また、その部分。
トツキユウ	特に急ぐこと。大急ぎ。主要な駅だけに止まり、早く目的地に到着するようにした電車。
トツクン	短期間に集中して特別の訓練を行うこと。また、その訓練。
トツシユツ	他と比べて、きわだっていること。突き出ること。
トツシン	目標に向かってまっしぐらに突き進むこと。
トツテ	手で持つための部分。
トツテオキ	いざというときのために大切にとっておくこと。また、そのもの。
トツニユウ	激しい勢いで中に入ること。勢いよく突っ込むこと。重大な事態に入ること。
トツパ	障害・困難などを突き破って通り抜けること。数量がある水準を超えること。
トツプ	首位。一位。順序の一番上。最上部。首脳。
トツプウ	突然、はげしく吹く風。
トツレンズ	真ん中が周りよりも厚いレンズ。小さな物が大きく見える。
トデン	東京都交通局が経営する路面電車。
トナカイ	寒い地方にすむ、シカの仲間の動物。
トナリ	自分の右か左に並んでいるもの。
トノサマ	江戸時代の大名や旗本を敬って呼ぶ言葉。
トビイリ	約束や予定なしにその場で急に参加すること。また、その人。
トビウオ	水面から高く飛び出すことができる、胸びれの大きい魚。あご。
トビキユウ	成績の特に優秀な者が例外的に一つ以上の学年・課程を飛び越して進級すること。
トビシヨク	土木・建築工事で、足場の組み立てやくい打ちなどに従事する職人。
トビドウグ	遠くから飛ばして敵などを撃つ武器。弓矢・鉄砲など。
トビバコ	体操用具の一つ。長方形の木枠を何段か重ね、その上部に布・革などでおおった台を置いたもの。
トビラ	開けるとびら。ドア。
トベイ	アメリカへ行くこと。
トホ	乗り物に乗らないで歩くこと。
トマト	野菜の一種で、赤くて水分の多い実を付ける。
トミ	集められた財貨・財産。経済的に価値のある資源。
トメガネ	物の継ぎ目や合わせ目が離れないようにとめておく金具。
トモ	親しい仲間。
トモカセギ	夫婦が二人とも働きに出て収入を得ること。共働き。
トモシビ	明かりにするために、ともした火。とうか。
トモダチ	親しい友人。友。
トラ	猫の仲間の猛獣。
トラツク	荷物を運ぶ貨物自動車。
トラノコ	大切にして手元から離さないもの。大事にしまってある金品。
トランク	大型で長方形の旅行かばん。乗用車の荷物入れ。
トランプ	室内遊戯に使うカード。また、それを使ってするゲーム。
トリ	つばさを持ち、体が羽毛でおおわれている動物。
トリイ	神社の前に立っている門。
トリエ	とりたててすぐれたところ。長所。
トリオ	三人組。三重奏。三重唱。
トリカゴ	小鳥を入れて飼うためのかご。
トリキメ	取り決めること。取り決めたこと。約束。契約。
トリクミ	問題などに取り組むこと。組み合わせ。相撲の勝負のこと。
トリゴヤ	ニワトリなどを飼っておくための小屋。
トリツ	東京都が設立し、管理・運営していること。また、その施設。
トリツク	人をだます仕かけ。
トリハダ	寒いときやこわいときなどに皮膚がぶつぶつになること。
トリヒキ	物品の売買を行うこと。互いが利益を得られるように両者が交換条件を受け入れること。
トリヨウ	物に色をつけたり、くさらないようにするために塗るもの。
トロビ	勢いの弱い火。弱火。
トン	重さの単位。千キログラム。
トンカツ	豚肉の切り身に小麦粉・とき卵・パン粉をつけて油で揚げた料理。
トンシヤ	豚を飼育するための小屋。豚小屋。
トンネル	山や地面をほり抜いた穴の通路。
トンボ	体が細長く、大きな複眼と四つの羽を持つ昆虫。
トースター	食パンを焼くときに使う電気器具。
ドア	戸。扉。
ドイツ	ヨーロッパ中部にある国。むかしから学問や芸術の分野ですぐれた人が多く出ている。首都はベルリン。
ドウ	首・手足・しっぽ以外の体の部分。
ドウアゲ	祝福や喜びの気持ちを表すために、大勢の人が一人の体を横にして何回も空中に投げ上げること。
ドウイ	賛成すること。同じ意味であること。
ドウイツシ	同じものとみなすこと。
ドウイン	ある目的のために人や物をかり集めること。
ドウカン	同じように感じること。同じような意見・考えであること。
ドウガ	動く絵。アニメーション。
ドウガン	子供の顔。どこか子供っぽさのある顔つき。
ドウキ	ある物事を始めるようになった要因。きっかけ。
ドウキヨ	いっしょの家で生活すること。
ドウクツ	がけや岩石中に生じた奥行きの深い穴。ほら穴。
ドウグ	物を作ったり、何かを行ったりするための器具。
ドウケイ	同じ型。
ドウサ	何かをするときの体の動かし方、ふるまい。
ドウシ	主義・主張・目的などを同じくする人。
ドウシユ	種類が同じであること。同じ種類のもの。
ドウジ	同じ時。二つのことがほとんど時間に差がなく起こること。
ドウセイ	姓が同じであること。同じ苗字であること。「○○○○同名」
ドウセン	銅で作った針金。
ドウゾウ	銅でできた像。
ドウタイ	動物の体の頭・首・手・足を取り除いた部分。
ドウテン	得点が同じであること。
ドウトク	人が守らなければいけない正しい行いの決まり。
ドウネン	同じ年。前に述べた、その年。
ドウハン	連れ添って行くこと。連れて行くこと。
ドウフウ	封筒の中に手紙と一緒に他の物を入れること。
ドウブツ	生物のうち、運動して、食べ物をとって食べて生きているもの。
ドウホウ	祖国を同じくする人々。
ドウミヤク	血液を心臓から体の各部分に運ぶ血管。
ドウメイ	名前が同じであること。同じ名。
ドウヨウ	子供のために作られた歌。わらべ歌。
ドウリヨウ	同じ職場で働いている仲間。同じ地位・役職の人。
ドウリヨク	機械などを動かすもとになる力。
ドウルイ	同じ仲間。
ドウロ	人や車などが通る道。
ドウワ	子どものために書かれた物語。
ドカン	粘土やセメントなどで作った管。
ドガイシ	関係のないものとして無視すること。問題にしないこと。
ドキ	粘土を焼成して作った素焼きの容器。
ドキヨウ	物事をおそれない心。
ドクガク	学校に通わないで、先生に教えてもらわないで、自力で勉強すること。
ドクサイ	特定の個人または集団が絶対的な権力を握って全体を支配すること。
ドクシヤ	本や新聞や雑誌などを読む人。
ドクシヨ	本を読むこと。
ドクシン	配偶者がいないこと。結婚していないこと。
ドクジ	他のものとはちがって、それだけが持っているもの。
ドクセン	自分だけのものにすること。
ドクター	英語で医者や博士のこと。
ドクダン	自分だけの考えで勝手に物事を決めること。また、その判断。
ドクトク	きわだった特徴がそのものだけが持っていること。
ドクリツ	他の人の世話にならずに生きていける状態になること。独り立ち。
ドコ	場所が決まっていないとき、場所がわからないときに使う言葉。
ドシヤ	土や砂。
ドシヤブリ	大粒の雨が激しく降ること。また、その雨。
ドジヨウ	小川や沼のどろの中ですむ魚。
ドスウ	含まれているアルコールの度合いを表す数値。
ドセイ	太陽から近い順に数えて六番目の軌道を回る惑星。サターン。
ドソク	はき物をはいたままのこと。どろの付いた足。
ドダイ	家や橋などの基礎として、下にあって重みを支えている部分。
ドチラ	どこかわからない場所や方向をたずねる言葉。
ドテ	土を小高く積み上げて築いた長い堤。堤防。
ドナタ	「だれ」を敬って言う言葉。
ドナベ	土を焼いて作ったなべ。
ドナー	臓器・骨髄移植で、臓器・骨髄などの提供者。
ドノウ	袋に土を詰め込んだもの。堤防などを築くのに使う。
ドヒヨウ	相撲の協議場。つき固めた土の周囲を土を詰めた俵で丸く囲んだもの。
ドボク	土と木。土石・木材・鉄材などを使って道路・鉄道・河川・堤防・橋梁・港湾などを建設する工事。
ドヨウ	金曜日の次の日。
ドライバー	ねじ回し。自動車などの運転手。
ドライヤー	ぬれた物をはやくかわかす道具。
ドラムカン	円筒形をした鋼鉄製の大きな缶。
ドリブル	サッカー・ラグビーなどでボールをけりながら進むこと。
ドリヨク	力いっぱいがんばること。
ドリル	らせん状の刃を回転させて穴をあける工具。
ドリンク	飲み物。飲料。
ドル	アメリカ・カナダなどのお金の単位。
ドレス	婦人服。特に、礼装用の婦人服。
ドロミズ	泥がまじってにごった水。
ドンカク	直角より大きく、二直角より小さい角。
ドンカン	感じ方がにぶいこと。
ドンブリ	茶わんより大きい、焼き物でできた入れ物。または、それに入った食べ物。
ドンヨク	きわめて欲の深いこと。
ドーナツ	小麦粉に卵や牛乳などを混ぜ、輪のようにして油であげた菓子。
ナイカ	主に内臓の病気を診断し、薬物療法などによって治療する臨床医学の分野。
ナイカク	国の政治を動かす最高機関。
ナイシヨ	秘密にしておくこと。
ナイシヨク	家計を助けるために自宅でする賃仕事。
ナイジユ	国内の需要。
ナイセイ	国内の政治。「○○○○干渉」
ナイゾウ	胸や腹の中にあって、呼吸や消化などのはたらきをしている器官をまとめて言う呼び名。
ナイテイ	正式の決定の前に内々に決まること。また、決めること。
ナイフ	洋食を食べるときに使う小さい刀。
ナイフク	薬を飲むこと。内用。
ナイブ	物の内側の部分。ある組織・集団などに属すること。また、その人。
ナイメン	ものの内側。
ナイヤ	野球のダイヤモンドの内部。○○○ゴロ。
ナイヨウ	ある物に入っている物。文章や話などで表された事がら。
ナエ	種子から芽を出して、まだ日の立っていない植物。
ナエギ	樹木の苗。特に、移植するために育てた若木。
ナエドコ	種をまいて作物の苗を育てる場所。
ナオザリ	物事を軽く見ていい加減にしておくこと。おそろか。
ナカナオリ	仲が悪かった者が、元通りに仲良くなること。
ナカニワ	敷地の中の建物に取り囲まれている庭。
ナカマ	いっしょに何かをする人たち。友達の集まり。
ナカマイリ	仲間に加わること。
ナカミ	中に入っている物。
ナカユビ	五本の指の真ん中にある指。
ナカヨシ	仲がいいこと。
ナガアメ	何日も長く降り続く雨。
ナガイキ	長く生きること。長寿。
ナガシ	流すこと。洗い水などを流す所。
ナガモチ	長い間、使える状態が続くこと。
ナガレ	水や物、時間などがある方向に動く様子。
ナキゴエ	虫・鳥・獣などの鳴く声。
ナキスナ	踏み歩くと「キュッキュ」と独特の音がする砂浜。また、その砂浜の土。
ナギサ	海・湖などの波が打ち寄せる所。波打ちぎわ。みぎわ。
ナギナタ	反り返った幅広の刀身に長い柄をつけた武器。人や馬をなぎ倒すのに使った。
ナグリガキ	急いで乱暴に書くこと。また、その書いたもの。
ナゲキ	深く悲しむこと。また、悲しみ憤ること。
ナゲワザ	相撲・柔道・レスリングなどで、相手を投げ倒す技。
ナコウド	結婚の仲立ちをする人。
ナゴリ	物事は終わっているのに、あとに何かが残っていること。
ナサケ	あわれむ心。思いやりの心。恋心。
ナザシ	名前を言って、それと指定すること。指名。
ナシ	バラ科の落葉高木。水分と甘味に富む果物。有りの実。
ナジミ	なれ親しんでよく知っていること。
ナス	こい紫色の卵形の実をつける野菜の一種。
ナスビ	ナスの別称。
ナズナ	アブラナ科の越年草。春の七草の一つで、ペンペングサとも呼ばれる。
ナゾ	実体のつかめないもの。不思議な事柄。
ナゾナゾ	言葉の中に他の物事を隠して、その意味を当てさせる遊び。なぞかけ。
ナタネ	アブラナの種子。アブラナの通称。
ナダ	波が荒くて、または潮流が速くて航海の困難な海域。
ナダレ	山にふって積もった雪が急にくずれ落ちること。
ナツ	四季のうち、春の次に来る暑い季節。
ナツイン	印鑑を押すこと。押印。
ナツトウ	大豆を発酵させた、ねばねばした食べ物。
ナツトク	考え方や意味がよくわかること。
ナツバテ	夏の暑さのためにばててぐったりすること。
ナツビ	夏の暑い日。特に、一日の最高気温がセ氏二十五度以上になる日。
ナツヤスミ	夏の間の長い休み。
ナヅケオヤ	生まれた子に名をつける人。ある物事に名前をつける人。
ナデガタ	なで下ろしたように、なだらかに下がっている肩。
ナナイロ	七種類の色。赤・だいだい・黄・緑・青・藍・すみれの七つの色。
ナナシ	名前がついていないこと。
ナナヒカリ	親や主人の威光で、子や後継者が大きな恩恵を受けること。
ナナメ	平行でも垂直でもなく、かたむいているさま。
ナニ	わからない物事、はっきりしない物事について、人にたずねたり、自分に問いかけたりする言葉。
ナニゴト	どのような事柄。どんなこと。あらゆること。何もかも。万事。
ナニモノ	名前・身分などのわからない人を指す言葉。だれ。あらゆる人。いかなる人。
ナノカ	一日の七倍。月の七番目の日。
ナノハナ	アブラナの花。菜種の花。
ナフダ	名前を書いてある札。
ナベ	食物を煮炊きするために使う、金属製または陶器製の器。
ナベゾコ	なべの底。
ナベブタ	なべのふた。
ナベモノ	なべで煮ながら食べる料理の総称。なべ料理。
ナマエ	人や物をほかのものと区別するために付ける呼び名。
ナマエマケ	名前がりっぱすぎて実物が劣ってみえること。
ナマガワキ	まだ十分に乾いていないこと。
ナマコン	すぐ使えるように練ってあるコンクリート。
ナマゴミ	魚・野菜などのくずや食べ残しなど、台所から出る水気の含んだごみ。
ナマザカナ	煮たり焼いたりしていない、生のままの魚。
ナマタマゴ	焼いたりゆでたりしていない、生のままの卵。
ナマビール	醸造したままで、加熱殺菌していないビール。生。
ナマミ	生きている体。生のままの魚肉。
ナマモノ	生のもの。加熱調理していないもの。
ナマリ	重くてやわらかい金属の一種。
ナミ	水が動いて水面に高低ができる現象。
ナミダ	悲しんだり、たいへんおかしかったりして、感情が強く動かされたときに、目から出てくる液体。
ナミノリ	板などを使って波のうねりに乗る遊び。サーフィン。
ナメコ	粘膜でおおわれた、日本特産のきのこの一種。食用で美味。広く人工栽培される。
ナヤミ	心配なこと。心の中で苦しむこと。
ナライゴト	芸事・技術などを習うこと。なま、習う事柄。
ナラク	地獄。物事のどん底。劇場で、舞台や花道の下。
ナラヅケ	シロウリなどの野菜を酒かすに漬けた食品。
ナラワシ	しきたり。習慣。風習。
ナリタチ	あるものができあがること。また、できあがるまでの過程。
ナリテ	それになる人。
ナリユキ	物事が自然に推移していく様子や過程。また、その結果。
ナレ	慣れること。習熟。
ナレツコ	すっかり慣れて、特別なことだと感じないこと。
ナレーター	映画・テレビ・ラジオなどの語り手。
ナワ	わらや麻などのせんいを細長く寄り合わせたもの。物をしばったりするのに使う。
ナワトビ	縄の両端を手で持って回転させ、その縄に当たらないように飛び跳ねる遊び。
ナワバシゴ	縄で作ったはしご。
ナワバリ	勢力の及ぶ範囲。
ナンカイ	わかりにくいこと。難しいこと。
ナンキヨク	地球のいちばん南のはし。
ナンキン	比較的ゆるやかな監禁。身体は拘束しないが、外部との交渉・接触を許さない状態に置くこと。
ナンコツ	やわらかくて弾性に富む骨。関節・鼻などに見られる。
ナンゴク	南の方の暖かい国。南の土地。
ナンザン	出産のとき、胎児がなかなか生まれないこと。
ナンスイ	カルシウム・マグネシウムなどのイオンをあまり含んでいない水。
ナンセイ	南と西の中間の方角。
ナンダイ	たやすくは解けない問題。解決するのがむずかしい事柄。
ナンチヨウ	聴力が低下して音声がよく聞き取れない状態。
ナントウ	南と東の中間の方角。
ナンバー	数。番号。数字。
ナンブ	ある地域の中で、南の方の部分。
ナンボク	南と北。
ナンモン	回答するのが難しい問い。解決するのが難しい問題。
ニイサン	若い男の人。自分の兄を親しみをこめて言う呼び名。
ニイヅマ	結婚して間のない妻。
ニオイ	鼻に感じるしげき。
ニオウダチ	仁王の像のようにどっしりといかめしく立つこと。
ニガオエ	人の顔に似せて描いた絵。
ニガツ	一年で二番目の月。
ニガリ	海水から食塩を結晶させた後に残る苦い溶液。
ニキビ	人の顔の毛穴などにできる小さな吹き出物。
ニギリメシ	飯を三角形や丸形に握り固めたもの。おにぎり。おむすび。
ニク	動物の骨を包んでいるやわらかな物質。
ニクガン	人間が生まれつき持っている目。また、その視力。
ニクギユウ	食肉をとるために飼う牛。
ニクシツ	肉の質。食肉の品質。
ニクシヨク	主に鳥やけものの肉を食べること。
ニクジヤガ	肉とジャガイモ・タマネギなどを甘辛く煮込んだ料理。
ニクズレ	積み荷がくずれること。
ニクセイ	マイクなどの機械を通さない、なまのままの声。
ニクタイ	生きている人間の体。「○○○○関係」
ニグルマ	人や牛馬が引いて荷物を運ぶ車。
ニゲミチ	逃げていく道。逃げる経路。責任などをのがれる手段。
ニコゴリ	ゼラチン質の多い魚などの煮汁が冷えて固まったもの。
ニゴリ	にごること。にごっていること。
ニザカナ	魚を醤油・砂糖などで味をつけて煮たもの。
ニシ	太陽が沈む方角。
ニシキ	金糸・銀糸などのさまざまな色糸を用いて華やかな文様を編み出した絹織物。
ニシビ	西に傾いた太陽。夕方に近づいて西からさし込む日ざし。
ニジ	雨がやんだ後に太陽の反対側の空にできる七色のアーチ型の光の帯。
ニジカイ	宴会が終わったのちに、場所を変えて開く二度目の宴会。
ニジユウ	二つ重ねること。二つ重なること。
ニジル	食べ物を煮た汁。また、食べ物を煮るために調味した汁。
ニセイ	二番目に家や地位を継いだ人。外国の移住者の子供で、生まれた国の市民権を持つ人。息子。
ニダイ	トラック・自転車などの、荷物を載せる台の部分。
ニチジ	日付と時間。日数と時間。
ニチジヨウ	ふだん。いつも。毎日。
ニチボツ	太陽が西の空に沈むこと。また、その時。
ニチヨウ	一週間の最初の日。
ニツカ	毎日必ずやると決めたこと。
ニツカン	毎日刊行すること。
ニツキ	その日の出来事や感じたことを書いたもの。日誌。
ニツコウ	日の光。太陽の光。
ニツシ	毎日の出来事や見たこと、したことなどを書き記したもの。
ニツシヨク	太陽・月・地球が一直線にならび、月が太陽の光をさえぎる現象。
ニツスウ	日にちの数。
ニツチユウ	日がのぼっている間。ひるま。
ニツテイ	その一日の予定。
ニツポン	アジア東部にある、私たちの住む国。
ニヅクリ	荷物を運送しやすいようにまとめて梱包すること。
ニド	二回。再び。「○○あることは三度ある」
ニドデマ	一度ですむことに二度の手間をかけること。
ニナイテ	荷物をかつぐ人。中心になってある物事を支え、推進していく人。
ニノウデ	肩からひじまでの間の部分。
ニフダ	送り先と送り主の住所・氏名などを書いて荷物につける札。
ニホン	アジア東部にある、私たちの住む国。
ニホンイチ	日本で一番であること。また、そのもの。
ニホンゴ	日本民族の用いる言語で、日本の公用語。
ニホンシユ	日本の伝統的な醸造法によって造られた酒。特に、清酒をいう。
ニホンジン	日本の国籍を持つ人。日本国民。
ニホントウ	日本の伝統的な鍛造法で作られた刀剣。
ニボシ	カタクチイワシ・イカナゴなどの稚魚を煮て干したもの。いりこ。
ニマイガイ	体が二枚の貝殻でおおわれている貝類の総称。
ニマイジタ	前と食い違うことを言うこと。うそをつくこと。
ニマイメ	映画・演劇などで、美男役の俳優。
ニマメ	味をつけてやわらかく煮た豆。
ニモウサク	同じ耕地で一年間に二種類の作物を栽培すること。
ニモツ	運ばれる品物。みんなに負担をかける人。
ニモノ	食材を調味して煮ること。また、その煮た物。
ニユウイン	けがや病気を治すために病院に入ること。
ニユウエキ	油脂・グリセリンなどを含む乳状の化粧品。
ニユウカ	商店・市場などに商品が入ること。
ニユウカイ	ある会に入って、その会員になること。
ニユウガク	新しい児童・生徒・学生として学校に入ること。
ニユウキヨ	ある住宅に入って居住すること。
ニユウコウ	船が港に入ること。
ニユウコク	他の国に入ること。
ニユウサツ	請負・売買などで、各競争者が見積価格などを書いて提出させること。
ニユウザン	山に入ること。
ニユウシ	学校が入学志願者の中から一定の入学者を選抜するために行う試験。「入学試験」の略。
ニユウシツ	部屋に入ること。
ニユウシヤ	新しく会社に入って、社員になること。
ニユウシユ	手に入れること。自分のものにすること。
ニユウジ	生後一年から一年半くらいまでの、母乳またはミルクで育てられる時期の子供。
ニユウセン	選考に入ること。応募した作品などが審査に合格すること。
ニユウダン	団に入って、その一員となること。
ニユウヨク	ふろに入ること。入湯。
ニユース	まだ知られていない新しい出来事。または、それを知らせる記事や番組。
ニヨウボウ	妻。自分の妻を指していう。
ニラメツコ	にらみ合うこと。向き合って互いにおかしな表情を作り、先に笑ったほうを負けとする子供の遊び。
ニリユウ	格式・程度・品質などが、一流より劣ること。
ニリンシヤ	車輪が二つある車。自転車・オートバイなど。
ニルイ	野球で一塁と三塁の間にある塁。
ニワ	家の敷地の中で、建物の立っていない所。
ニワカアメ	急に降り出してすぐにやんでしまう雨。
ニワキ	庭に植える木。庭に植えてある木。
ニワトリ	頭にとさかがある、人に飼われる鳥。
ニンカ	よいと認めて許可すること。
ニンキ	世間一般の人々に好まれ、もてはやされること。
ニンギヨ	体の上半身は女性で、下は魚の姿である、想像上の動物。
ニンギヨウ	人や動物の形に似せて作ったおもちゃ。
ニンゲン	人類。動物の一種としての人。
ニンシン	女性が受胎して体内に子を宿すこと。身ごもること。懐妊。
ニンジヤ	忍術を使って間諜・謀略活動などを行う者。忍術使い。忍びの者。
ニンジユツ	姿を隠して敵方にひそかに入り込む術。
ニンジヨウ	他人に対する思いやりの心や情け。
ニンジン	畑でとれる、黄色や赤色をした根の野菜。
ニンズウ	人の数。
ニンソウ	人の顔つき。容貌。
ニンテイ	資格の有無などについて判断して認めること。
ニンニク	ユリ科の多年草。鱗茎（りんけい）と葉は食用・薬用。独特の強いにおいを持つ。ガーリック。
ニンプ	妊娠している女性。
ニンベン	「作」「位」「働」などの漢字の左側の部首。
ニンム	自分の引き受けた役目。
ニンメイ	ある役につくよう命じること。
ヌイグルミ	綿などを中に入れてぬい合わせたおもちゃ。
ヌイシロ	布地をぬい合わせるとき、ぬい込み用として仕立て寸法以外にとっておく部分。
ヌイバリ	衣服をぬうために使う針。先に糸を通す穴がある。
ヌイメ	布と布をぬい合わせた境目。ぬった糸の目。
ヌカ	玄米をついて白米にするときにできる粉。
ヌカヅケ	ぬかみそに野菜を漬けること。また、その漬け物。
ヌカミソ	ぬかに塩・水を加え、よくかき混ぜて発酵させたもの。
ヌカルミ	どろなどが、ぐちゃぐちゃになっている所。
ヌキウチ	刀を抜くと同時に切りつけること。予告なしに不意に物事を行うこと。
ヌクモリ	わずかに感じられるあたたかさ。
ヌケアナ	とおりぬけられる穴。抜け道。
ヌケガラ	昆虫やヘビなどが脱皮した後の殻。
ヌケゲ	髪の毛が抜け落ちること。また、その毛髪。
ヌノ	糸をたて・横に組み合わせて織ったもの。
ヌマ	泥が深く、藻（も）などが生い茂る水域。
ヌマチ	泥の深い湿地。また、沼の多い土地。
ヌリエ	輪郭だけが印刷された絵に色を塗って遊ぶこと。
ヌリグスリ	患部の皮膚に直接塗る薬。塗布剤。
ヌリタテ	塗ったばかりであること。
ヌルマユ	温度の低い湯。ぬるい湯。
ネアガリ	物の値段が上がること。
ネアゲ	物の値段を上げること。
ネアセ	眠っている間にかく汗。
ネイキ	眠っている間の呼吸。また、その音。
ネイル	つめ。
ネイロ	同じ強さ・高さの音でも楽器の違いや音の出し方によって生じる、それぞれの音の特性。
ネウチ	そのものが持っている尊さや、役に立つ程度。価値。
ネエサン	若い女の人。自分の姉を親しみをこめていう呼び名。
ネガイ	こうしてほしいとたのむこと。ねがうこと。
ネガイゴト	願う事柄。特に、神仏に祈願する事柄。
ネガオ	眠っているときの顔つき。
ネギ	畑で作る野菜。全体が細長い管の形で、地上の部分は青く、地中は白い。
ネギボウズ	ネギの花。
ネギマ	材料にネギとマグロを使った料理。
ネクタイ	ワイシャツなどのえりもとに巻いて前で結ぶ帯状の飾り布。
ネグセ	寝ている間に髪の毛についたくせ。
ネコ	形がトラに似た動物。犬と同じようにペットとして飼われる。
ネコジタ	熱いものをすぐに食べられないこと。
ネコゼ	ねこのように背中が丸くなっている格好。
ネコミ	寝ている間。よく眠っている最中。
ネゴコチ	寝たときの感じ。また、眠っているときの心持ち。
ネゴト	ねむっているときに知らずに言う言葉。
ネサガリ	物の値段が安くなること。
ネサゲ	物の値段を安くすること。
ネジ	二つの物をくっつけて固定するために使う、先がらせん状になっているくぎ。
ネジマワシ	ねじを回すときに使う道具。ドライバー。
ネズミ	歯がするどく、体の小さなけもの。
ネゾウ	人が眠っているときのかっこう。ねざま。
ネダン	品物を売り買いするときの金額。
ネツ	物の温度を高くするはたらき。
ネツイ	物事に対する強い意気込み。熱心な気持ち。
ネツキ	高い温度の空気。
ネツキヨウ	気が狂ったように夢中になること。
ネツクレス	首に巻いて胸元をかざるアクセサリー。首かざり。
ネツシヨウ	情熱を込めて歌うこと。
ネツシン	一つの物事に心をこめて、一生懸命取り組むさま。
ネツタイ	赤道を中心にして南北両回帰線にはさまれた、一年中暑い地域。
ネツタイヤ	屋外の最低気温がセ氏二十五度以下に下がらない夜。
ネツチユウ	ある物事に夢中になること。
ネツトウ	とても温度の高いお湯。
ネトマリ	ある期間、そこに宿泊すること。
ネドコ	寝るために敷いた寝具。
ネバリ	やわらかくて、物にくっつきやすい性質。ねばりけ。あきらめないで、がまん強く最後までやる気持ち。
ネバリケ	ねばり付く性質。ねばる力。
ネビキ	品物の値段を、一度決めた値段よりも安くすること。
ネフダ	値段を書いた札。
ネブクロ	羽毛・綿などの保温材を詰めた袋状の寝具。
ネブソク	ねむりが足りないさま。睡眠不足。
ネボウ	朝おそくまで寝ていること。また、その人。
ネマキ	寝るときに着る衣服。
ネムケ	眠くて眠くてしかたがない気持ち。
ネムリ	ねむること。ねむった状態になること。
ネモト	草や木の根のある辺り。
ネライ	ねらうこと。何かをしようとするときの目当て。目標。
ネンエキ	粘り気のある液体。
ネンカン	一年の間。
ネンガ	新しい年をむかえたお祝い。
ネンガツピ	何年何月何日という日付。
ネンガン	いつも心にかけて望み願うこと。また、その願い。
ネンキン	一定期間または終身、毎年定期的に支給される定額の金銭。
ネンゲツ	年と月。
ネンゴウ	年につける称号。元号。
ネンシユウ	一年間で入ってくるお金や、生産物のとれ高の合計。
ネンシユツ	知恵をしぼって考え出すこと。やりくり・工夫して金銭や時間を作ること。
ネンシヨ	後日の証拠として念のために作成する文書。
ネンシヨウ	燃えること。
ネンジユウ	一年を通してずっと。
ネンスウ	年の数。
ネンチヤク	ねばり付くこと。
ネンド	水をふくむとねばりけがでる土。
ネンパイ	かなり年を取っている人。中年。
ネンピ	機械がある仕事をするのに必要な燃料の量。「低○○○」
ネンピヨウ	歴史上の事件などを年代順に記載した表。
ネンマツ	一年の終わりのころ。
ネンリヨウ	燃やす材料。
ネンレイ	生まれてから、今その時までの年月。歳。
ノウカ	農業によって暮らしている家。
ノウキ	税金・商品などを納める期日。また、納入の期限。
ノウキグ	農作業に使用する機械・器具。
ノウキヨウ	「農業協同組合」の略。
ノウギヨウ	田畑を耕したり、植物を栽培したり、家畜を飼育したりする産業。
ノウサギ	野生のウサギの総称。
ノウシユク	煮詰めるなどして溶液の濃度を高くすること。
ノウジヨウ	農業経営に必要な土地・建物・設備などを備えた一定の建物。
ノウゼイ	国などに税金を納めること。
ノウソン	主に農業によって生活している人々が暮らしている村。
ノウチ	農業のために使われる土地。
ノウド	液体や気体の濃さの度合い。
ノウナイ	脳の内部。
ノウニユウ	金銭や品物を納めること。
ノウハ	脳の神経細胞の活動によって発生する弱い電流の変化。また、それを記録した図。
ノウヒン	品物を納入すること。また、その品物。
ノウフ	官公庁などに金銭や品物を納めること。
ノウミン	農業をしている人々。
ノウヤク	草取りや害虫を殺すための農業用の薬。
ノウリツ	一定の時間内にできる仕事の量。仕事の進み具合。
ノウリヨク	物事をなしとげたり、理解できる力。
ノキ	屋根の下端の、建物の外壁より外に張り出している部分。
ノキシタ	軒（のき）の下。
ノギヘン	「秋」「科」「積」などの漢字の左側の部首。
ノコギリ	木材を引き切る道具。
ノコリモノ	あとに残っているもの。余り物。
ノザラシ	野外で風雨にさらされること。また、そのもの。
ノジユク	野外で夜を明かすこと。野原や山でねること。
ノゾミ	望むこと。願い。希望。
ノツク	部屋に入る前にとびらをたたいて合図すること。
ノツポ	たいへん背が高いこと。背が高い人。
ノド	首の部分。口のおくの方。声が出る所。
ノドゴシ	飲食物がのどを通っていくときの感じ。
ノハラ	建物がなく、草が一面に生えた、広い平地。
ノバナシ	家畜などを放し飼いにすること。
ノバラ	野生のバラの総称。
ノビチヂミ	伸びることと縮むこと。伸びたり縮んだりすること。しんしゅく。
ノベボウ	金属を延ばして棒状にしたもの。もち・麺類などを平らに延ばすのに使う木製の棒。
ノミグスリ	飲用する薬。内服薬。
ノミコミ	物事を理解すること。「○○○○が早い」
ノミミズ	人が飲むための水。飲料水。
ノミヤ	酒を飲ませる店。居酒屋。
ノヤキ	新しい草がよく生えるように、早春、枯れ草に火をつけて野を焼くこと。
ノヤマ	野と山。野や山。
ノライヌ	飼い主のいない犬。野犬。
ノラネコ	飼い主のいない猫。どら猫。
ノリ	でんぷん質の物を煮て作った、ねばりけのあるもの。物をはるのに使う。
ノリオリ	乗ることと降りること。乗降。
ノリカエ	乗り物や立場などを乗り変えること。
ノリキ	進んでそうしてみようとする気持ちであること。
ノリゴコチ	乗り物などに乗ったときの感じ。
ノリシロ	紙をはり合わせるとき、のりをつけるために設けてある部分。
ノリバ	乗り物に乗るために設けられた場所。
ノリモノ	人を乗せて運ぶもの。
ノレン	商店で、屋号・店名などを染め抜いて店の出入り口に掲げておく布。
ノンキ	心配や苦労のないさま。気が長く、のんびりしているさま。気にかけず、平気でいるさま。
ノー	英語で「いいえ」「いやです」など否定の意味を持つ言葉。
ノート	ものが書けるように紙をとじた物。書き留めること。覚え書き。
ハアク	しっかりとつかむこと。はっきりと正しく理解すること。
ハイ	物が燃えつきた後に残る、粉のような物。
ハイアン	議決・採用されずに廃止された議案。
ハイイロ	灰のようなうすい黒色。ねずみ色。
ハイカイ	あてもなく歩き回ること。
ハイキ	内部の気体を外に出すこと。
ハイキユウ	一定の量の品物をめいめいに割り当てて配分すること。
ハイク	五・七・五の十七音からできている短い詩。
ハイケイ	写真や絵で、主になる物の後ろや周りの部分。ある出来事についての事情。
ハイケン	見せていただくこと。読ませていただくこと。
ハイコウ	学校を廃止すること。また、その学校。
ハイゴ	背中のうしろの方。
ハイザラ	タバコの灰や吸い殻を入れる容器。
ハイシ	今までやってきたことをやめること。取りやめて行わないこと。
ハイシヤ	歯の病気を治療する医者。歯科医。また、その医院。
ハイシユツ	内部にたまった不要の物を外へ押し出すこと。
ハイスイ	いらなくなった水を流すこと。
ハイセツ	生物体が体内に生じた不用な物質を体外に出すこと。排出。
ハイソウ	品物を配達して送り届けること。配達と配送。
ハイタツ	新聞や郵便物などを目的の場所へ送り届けること。
ハイチ	人や物を、それぞれ適当な場所に割り当てて置くこと。
ハイテン	試験問題の合計点を各問題や科目に振り分けること。また、その点。
ハイヒン	役に立たなくなった品物。不用の品物。廃物。「○○○○回収」
ハイビ	必要な手配・配置をして準備を整えること。
ハイフ	多くの人に配ること。
ハイホウ	肺の内部の細気管支の先端にある半球状の小室。
ハイヤク	映画・演劇などで、俳優に役を割り当てること。また、その役。キャスト。
ハイユウ	映画・演劇・テレビドラマなどに出演することを職業とする人。役者。
ハイラン	卵子が卵巣から排出されること。
ハイリヨ	あれこれと細かく心を配って思いやること。
ハイレツ	順序立てて並べること。また、その並び。
ハウス	英語で「家」「建物」「小屋」などの意味を表す言葉。
ハエギワ	額・えり首などの髪の生えている部分と生えていない部分の境目のあたり。
ハオリ	和装で、長着の上に着る丈の短い外衣。
ハカセ	博士（はくし）の通称。学問や芸道などで、その道に深く通じている人。
ハカマ	和装で、着物の上につけて腰から下をおおう、ゆったりとした衣服。
ハカライ	考えて処置すること。「取り○○○○」
ハカリ	物の重さをはかる道具。
ハカリウリ	客の求める分量だけ、そのつどはかって売ること。
ハガキ	第二種郵便に使用する一定規格・様式の通信用紙。「郵便○○○」
ハガタ	歯でかんだあと。歯並びを石膏などで写し取ったもの。
ハガネ	二パーセント以下の炭素を含む強靭な鉄。鋼鉄。
ハキモノ	くつ・げた・サンダルなどの、歩くときに足にはくもの。
ハキユウ	波紋が広がるように、物事の影響がしだいに広がっていくこと。
ハキヨク	物事が行き詰って、それまでの状態を維持できなくなった局面。悲惨な終局。
ハギシリ	ねている間に無意識に歯をすり合わせて音を出すこと。くやしいときなどに上下の歯を強くかみ合わせるしぐさ。
ハギレ	歯で物をかみ切るときの感じ。話し方がはっきりしている度合い。
ハクアイ	すべての人を広く平等に愛すること。
ハクイ	白い衣服。特に、医師・看護師・化学者などが着る白い外衣。
ハクガイ	弱い立場にある者を圧迫して、ひどく苦しめること。
ハクサイ	アブラナ科の野菜。葉が大きくまとまって楕円形や卵型になる。漬物や煮物に用いられる。
ハクシ	文字や絵がかかれていない白い紙。
ハクシキ	広い知識をもっていること。博学。多識。
ハクシユ	うれしいとき、感動したときなどに、両手のてらを打ち鳴らすこと。
ハクシヨ	政府の各省庁が行政活動の現状や将来の展望などについて発表する年次報告書。
ハクジヤク	意志・体力などが弱いこと。
ハクジユ	数え年九十九歳。また、その祝い。
ハクジン	白色人種に属する人。
ハクセイ	骨格・筋肉・内臓などを取り除いて皮だけを残し、中に綿を詰め、防腐処理を施したもの。
ハクダク	白くにごること。
ハクチヨウ	全身が白くて、首が長くて美しい大型の水鳥。
ハクネツ	高温に熱せられた物体が白い光を放つこと。「○○○○電球」
ハクハツ	白くなった頭髪。しらが。
ハクバ	白い毛色の馬。
ハクマイ	玄米をついて糠・胚芽などを取り除いて白くした米。精米。
ハクリ	はがれること。また、はがすこと。
ハクリキコ	軟質小麦から製粉した、たんぱく質・グルテンの少ない小麦粉。
ハクリヨク	人の心に強く迫ってくる力。
ハグキ	歯の根元をおおっている粘膜層。
ハグルマ	機械などで使う、回りにぎざぎざの歯がついた車。
ハケ	獣毛などを束ね、柄に植えつけた道具。のりや塗料を塗るのに使う。
ハケン	任務を命じて他の会社や場所へ行かせること。「○○○切り」
ハゲ	かみの毛が抜け落ちてつるつるしていること。
ハゲアタマ	頭髪が抜け落ちた頭。とくとう。
ハゲヤマ	草木の生えていない山。
ハコ	木・紙・金属などで作った四角い入れ物。
ハコニワ	浅い箱の中に土砂を入れ、小さな木や草を植え、庭園を小さく再現したもの。
ハコボレ	刀・包丁などの刃が部分的に欠けること。また、その部分。
ハゴイタ	羽根突きに使う、柄のついた長方形の板。
ハゴタエ	物をかんだときに歯に受ける抵抗感。
ハゴロモ	天人が着て空中を飛ぶという薄くて軽い衣。
ハサキ	刃の先端。刀などの切っ先。
ハサミ	物をはさんで切る道具。じゃんけんのちょきのこと。
ハサミウチ	相手を両側からはさむようにして攻撃すること。挟撃。
ハザクラ	花が散って若葉が出始めたころの桜。
ハシ	川や谷・道路などの上にかけわたし、両側の地点をつなぐ役目をするもの。
ハシオキ	食卓で、はし先をのせておく小さな器具。はし台。はしまくら。
ハシゲタ	橋脚の上にわたして橋板を支える材。
ハシゴ	高い所に上るときに使う道具。
ハシタガネ	半端な金銭。ごくわずかな金銭。
ハシヤ	武力によって天下を治める者。競技などで優勝した者。
ハシラ	屋根や二階の重さを支えている、たてに長い建築材。中心となって支えているもの。
ハシリガキ	急いで続けざまに文字を書き記すこと。またその書き記したもの。
ハシワタシ	橋を掛け渡すこと。両者の間に入って仲立ちをすること。
ハジマリ	物事が始まること。始まる時。起源。
ハジメ	物事の最初。それが始まったころ。
ハス	レンコンが取れる多年生水草。
ハズミ	ぶつかってから、はね返る動き。
ハセイ	もとになる物事から分かれて生じること。
ハタ	布や紙で作り、国の印やかざり、信号などを表すのに使うもの。
ハタアゲ	旗を揚げること。新しく団体などを組むこと。
ハタオリ	はたで布を織ること。
ハタキ	室内や器物のほこりをはらう道具。
ハタケ	穀物・野菜・草花などを栽培する土地。
ハタザオ	旗をつけて掲げるためのさお。
ハタチ	二十歳。
ハタラキ	仕事。能力。労働。活動。その物が持つ力。
ハタラキテ	働く人。特に、働いて一家の生計の中心になる人。
ハダ	ひふの表面。物の表面。
ハダアレ	肌が荒れること。皮膚がかさかさになること。
ハダカ	体に何も着ていない状態。
ハダギ	肌に直接つけて着る衣類。下着。
ハダザワリ	肌に触れたときに受ける感じ。
ハダシ	足にはき物をはいていない状態。
ハチ	四枚の羽を持つ昆虫の一種。しりに付いている針で人をさすことがある。
ハチアワセ	頭と頭が正面からぶつかり合うこと。偶然に出会うこと。
ハチマキ	長細い布で頭の鉢の周りを巻くこと。また、その布。
ハチミツ	みつばちが花から集めてきた、あまいみつ。
ハチヨウ	波動の山と山、または谷と谷の間の水平距離。
ハツアン	新しい考えを出すこと。議案を作成して提出すること。
ハツイク	育って大きくなること。成育。
ハツオン	声や音を出すこと。
ハツカ	二十日。
ハツカテン	物質が空気中で自然に発火する最低温度。
ハツカン	汗をかくこと。
ハツガ	草や木の種が芽を出すこと。
ハツガツオ	初夏のころ最初に市場に出回るカツオ。
ハツキ	持っている力を十分に外に出し切ること。
ハツキン	白金属元素の一つ。プラチナ。
ハツクツ	地中に埋もれている遺跡・遺物などを掘り出すこと。
ハツケン	まだ知られていなかった事や物を、初めて見つけ出すこと。
ハツゲン	意見などを述べること。また、その言葉。
ハツコウ	光を放つこと。
ハツコツ	白い骨。
ハツゴオリ	その冬に初めて張った氷。
ハツサン	内部にたまったものを外に出すこと。「ストレスを○○○○する」
ハツシモ	その年の秋から冬にかけて初めて降りる霜。
ハツシン	自動車や乗り物が進み始めること。
ハツセイ	物事が起こること。それまでなかったものが生じること。
ハツソウ	思い付くこと。自分の考えを表すこと。
ハツタツ	進歩してすぐれたものになっていくこと。
ハツチユウ	注文を出すこと。特に、生産者に製品の注文を出すこと。
ハツテン	どんどんさかえて立派になっていくこと。のび広がること。発達。
ハツデン	電気を発生させること。
ハツドウキ	動力を起こす機械。エンジン。内燃機関。
ハツネツ	熱を発生すること。体温が平常より高くなること。
ハツバイ	物を売り出すこと、売り始めること。
ハツピヨウ	人々に広く知らせること。
ハツブタイ	役者として初めて舞台に上がって演技を披露すること。
ハツミミ	初めて聞くこと。
ハツメイ	まだだれも考え付かない新しい物を考え出したり、作り出したりすること。
ハツモウ	毛根から毛が生えること。
ハツユキ	その年で初めて降る雪。
ハツユメ	その年、初めて見る夢。
ハツレイ	法令・辞令・警報などを出すこと。
ハデ	姿・形・色彩などがはなやかで目立つこと。大げさで目立つこと。
ハト	頭が小さくて丸く、くちばしが短い鳥。平和の象徴。
ハトムネ	ハトの胸のように高く突き出た胸。
ハナ	植物がくきの先でさかせるもの。美しくはなやかな様子。
ハナイキ	鼻でする息。
ハナウタ	鼻にかかった小声で歌を歌うこと。または、その歌。
ハナオ	下駄やぞうりの緒の、足の指ではさむ部分。
ハナガツオ	かつお節を花びらのように薄く削ったもの。
ハナシ	自分の考えなどを人に向かって言うこと。しゃべること。
ハナシアイ	話し合うこと。
ハナシゴエ	話をしている声。
ハナシテ	話をする人。話のうまい人。
ハナゾノ	花の咲く草木を多く植えてある庭園。
ハナタバ	草花を何本か束ねたもの。
ハナヂ	鼻の穴からの出血。
ハナビ	火薬をまぜ合わせてかためたもので、火をつけてそれが出す音や美しい光を楽しむための物。
ハナビラ	花を作っている、ひらひらしたうすいもの。
ハナフブキ	桜の花びらが風に吹かれて乱れ散るさまをふぶきに見立てた言葉。桜吹雪。
ハナミ	花、とくに桜の花をながめて楽しむこと。
ハナムコ	結婚したばかりの男性。また、結婚式当日の新郎。
ハナヨメ	結婚したばかりの女性。また、結婚式当日の新婦。
ハナラビ	歯の並び具合。
ハナレジマ	陸地から遠く離れた島。孤島。離島。
ハナレワザ	人を驚かすような大胆・奇抜な芸当や仕業。危険なわざ。
ハナワ	花で作った輪。
ハニワ	古墳の上部や周囲に並べられた素焼きの土製品。
ハネ	鳥や昆虫類が空を飛ぶための器官。
ハネツキ	羽子板で羽根をついて遊ぶこと。また、その遊び。
ハネブトン	鳥の羽毛を入れた上等の布団。軽くて暖かい。
ハハ	おかあさん。
ハハオヤ	母である親。女親。
ハハノヒ	子供が母の愛に感謝する日。五月の第二日曜日。
ハバ	物の左右のはしからはしまでの長さ。
ハブラシ	歯をみがくのに使う小さなブラシ。
ハヘン	壊れた物のかけら。
ハマ	海や湖の水際に沿った平らな陸地。浜辺。
ハマキ	タバコの葉を刻まずに、そのまま固く棒状に巻いたタバコ。シガー。
ハミガキ	歯をみがいてきれいにすること。
ハム	豚肉を塩漬けにし、くん製にした加工食品。
ハムスター	ネズミ科の哺乳類。実験用・愛玩用に飼育される。
ハヤアシ	普通より速く歩くこと。急ぎ足。
ハヤウチ	続けざまに早い調子で打つこと。
ハヤオキ	朝早く起きること。
ハヤクチ	しゃべり方が早いこと。くちばや。
ハヤザキ	普通の開花時期より早く咲くこと。また、早く咲く品種。
ハヤシ	木がたくさん集まって生えている所。
ハヤトチリ	早合点して、まちがえること。
ハヤネ	夜、早い時刻に寝ること。
ハヤリ	流行。
ハヤワザ	すばやくて巧みなわざ。すばやい動作。
ハラ	動物の内臓が入っている部分とその周り。おなか。
ハラマキ	冷えるのを防ぐために腹に巻きつける幅の広い布。はらおび。
ハリ	布や皮をぬったり、物をさすための、細長く先のとがった物。
ハリガネ	金属をひものように細くのばしたもの。
ハリガミ	のりではり付けた紙。紙をはること。
ハリコ	木型に紙を何枚も張り付けて重ね、乾いてから型を抜き去って作った物。
ハリシゴト	裁縫。縫い物。
ハリネズミ	背中全体に針のようなとげが生えている小動物。ヤマアラシより針が短い。
ハル	四季の一つで、冬と夏の間の季節。
ハルサメ	春、静かに降る細かい雨。
ハレ	空にくもの少ない状態。
ハレギ	公の場所や改まった席に着て出る晴れやかな衣服。よそいき。
ハレスガタ	晴れ着を着た姿。晴れの場所に出たときの姿。
ハレツ	勢いよくはじけること。やぶれてさけること。
ハレツオン	物が破裂した音。
ハワイ	太平洋にあるアメリカ合衆国五十番目の州。観光地。
ハワタリ	刃物の刃の長さ。
ハンイ	限られた領域。
ハンエイ	勢いが盛んになること。富み栄えること。
ハンカガイ	商店・飲食店などの多い、にぎやかな地域。
ハンカチ	手ふきや装飾に用いる正方形の小さな布。
ハンガ	版を用いて転写した絵。
ハンガク	決まった額の半分。
ハンガー	洋服かけ。
ハングル	朝鮮語の表記に用いられる文字。
ハンケイ	直径の半分の長さ。
ハンケツ	訴訟事件に対して裁判所が言い渡す判断。
ハンゲツ	半円形の月。
ハンコ	印鑑。はん。
ハンシ	24cm×34cmぐらいの大きさの和紙。習字などに使う。
ハンシヤ	光や音が物に当たって、はね返ること。
ハンシヨク	動物・植物が生まれて増えること。
ハンジユク	果実などが十分に熟していないこと。卵が完全に固まっていない状態。
ハンジヨウ	いぎわって栄えること。
ハンスウ	全体の数の半分。
ハンズボン	丈がひざくらいまでのズボン。
ハンセイ	自分の行いをふり返って、よかったどうかを考え直してみること。
ハンソデ	洋服でひじくらいまでの長さのそで。
ハンダ	すずと鉛の合金。金属の接合に用いられる。
ハンダン	物事の善悪・優劣・方法などを考え、どちらかに決めること。
ハンチヨウ	班を統率する責任者。
ハンツキ	一ヶ月の半分。
ハンテイ	いいか悪いか、勝ちか負けかなどを見きわめて決めること。
ハントウ	海に向かって長く大きく突き出した陸地。
ハントシ	一年の半分。
ハンドル	機械を運転するために付けられている、手でにぎる物。
ハンニチ	日本または日本人に反感を持つこと。
ハンネ	半分の値段。
ハンノウ	生物などが受けたしげきにおうじて起こす動きや変化。
ハンバイ	売りさばくこと。売ること。
ハンピレイ	ある量が他の量の逆数に比例すること。
ハンブン	二等分したものの一方。二分の一の数量・分量。
ハンプク	何度も繰り返すこと。
ハンベツ	はっきり見分けること。他と区別すること。
ハンマー	大型のかなづち。
ハンメイ	はっきりとわかること。明らかになること。
ハンロン	相手の意見などに対して、反対意見を述べること。
ハート	英語で心臓や心の意味を持つ言葉。
バイウ	六月から七月中旬にかけて降る季節的な長雨。つゆ。
バイオリン	約六十センチの弦楽器の一種。馬の尾の毛を張った弓でこすって演奏する。
バイキヤク	売り払うこと。
バイシユウ	買い取ること。金品を与えて自分の有利になるように人を動かすこと。
バイシヨウ	他人・他国に与えた損害をつぐなうこと。
バイスウ	ある整数の何倍かの数。
バイゾウ	二倍に増えること。二倍に増やすこと。
バイテン	駅・劇場・病院・学校内などに設けられた小さな店。
バイバイ	売ることと買うこと。売り買い。
バイヨウ	細菌・細胞などを人工的に発育・増殖させること。
バクオン	エンジンが発する音。火薬・ガスが爆発するときの音。
バクシヨウ	大勢が声をあげていっせいに笑うこと。
バクチク	小さな紙筒や竹筒に火薬を詰めて多数つないだもの。
バクフ	鎌倉・室町・江戸の三代にわたる、武家政権の政庁や機構。
バクマツ	江戸幕府の末期。
バケツ	水などの液体をくんだり、運んだりする深い入れ物。
バケモノ	動植物などが奇怪な姿・形をして現れ出たもの。おばけ。妖怪。
バシヤ	馬が引く、人や荷物を運ぶための車。
バジユツ	馬を乗りこなす術。
バス	たくさんの人がいっぺんに乗ることができる乗合自動車。
バタアシ	水泳で、伸ばした両足を交互に上下させて、足の甲で水を打つこと。
バター	牛乳からとったあぶらを固めた食べ物。
バチガイ	その場にふさわしくないこと。
バツク	英語で後ろのこと。後ろに戻ること。逆もどり。帰ってくること。
バツグン	多くのものの中で特にすぐれていること。とびぬけていること。
バツサイ	樹木や竹を切り倒すこと。
バツタ	草むらを大きく飛び跳ねる昆虫の一種。
バツター	野球やクリケットなどの打者。
バツト	野球などで、ボールを打つときに使う木製または金属製の棒。
バナナ	アジア熱帯地方原産の、皮が黄色または緑色で、中身が白い甘い果物。
バニク	食用の馬の肉。
バネ	弾力のある物で作られ、振動やショックをやわらげたりするもの。
バメン	映画・演劇などの、一つの情景。シーン。
バラ	くきにとげがある低い木。いい香りの花をつける。
バライロ	薄い紅色。希望や喜びにあふれた様子。
バラニク	あばら骨を包んでいる肉。三枚肉。
バランス	英語でつり合いのこと。均衡。
バレイシヨ	ジャガイモの別名。
バレリーナ	バレエで女性の踊り手。
バングミ	テレビやラジオで、放送する内容の単位。
バンケン	家の番をさせるために飼う犬。
バンゴウ	順番を表したり、見分けるのに役立てたりするための数字。ナンバー。
バンゴハン	晩の食事。夕ご飯。
バンサン	夕食。ディナー。
バンザイ	うれしいとき、おめでたいときに両手を上げ、大声で言う言葉。
バンゼン	まったく手抜かりのないこと。あらゆる点で完全なこと。
バンソウ	器楽・声楽のメロディーに合わせて他の楽器で補助的に演奏すること。
バンニン	番をする人。見張りをする人。
バンノウ	何でもできること。すべてに役に立つこと。
バンメシ	晩の食事。夕食。夕めし。
バーナー	ガス・液体燃料・微粉炭などを燃焼させて高温を得る装置。
バーベル	鉄棒の両端に鉄製の円盤をはめ込んだ運動用具。
パジヤマ	ゆったりとした西洋風の寝巻き。寝るときに着る。
パスタ	イタリア料理に使うめん類の総称。
パスポート	外国に旅行する人の身分・国籍を証明する公文書。旅券。
パズル	頭を使って考えるための問題。
パソコン	個人向けのコンピューター。
パツク	英語で包むこと。顔のしわや汚れを取るために顔に何かを塗ったり貼ったりすること。
パトカー	「パトロールカー」の略。
パフエ	アイスクリームにチョコレート・生クリーム・果物などを添えたお菓子。
パリ	フランスの首都。
パンク	自動車や自転車などのタイヤに穴があくこと。
パンコ	パンを乾かして細かく砕いたもの。フライの衣などに用いる。
パンジー	三色すみれ。
パンダ	アライグマ科の哺乳類。竹を主食とする、白黒の珍獣。
パーキング	駐車すること。
パーツ	機械・器具などの部品。
ヒアタリ	日光が当たること。日の当たり具合。
ヒエシヨウ	血行が悪いために体が冷えやすい体質。また、その症状。
ヒカエシツ	控えて待つための部屋。
ヒカエメ	えんりょがちに物事をしたり、言ったりするさま。
ヒカク	二つ以上のものを比べること。
ヒカゲ	日の当たらない暗い部分。
ヒカゲン	火力の程度。
ヒカリ	人の視神経を刺激して明るさを感じさせるもの。電磁波の一種。
ヒガエリ	その日のうちに帰ってくること。
ヒガサ	強い日光をさえぎるためにさす傘。
ヒガシ	太陽が出てくる方角。
ヒガワリ	毎日替わること。
ヒキ	けもの・魚・虫などを数える言葉。
ヒキアゲ	引っぱって上げること。
ヒキウス	上下に円盤状の石を重ね、上の石を回して間に入れた穀物を粉にする道具。
ヒキカエ	交換すること。
ヒキガネ	小銃・ピストルなどで、弾丸を発射させるときに指で引く金具。
ヒキギワ	仕事・地位・立場などから退くときの時期や態度。引け際。
ヒキコモリ	人間関係や社会参加を避けて、自宅や自室にひきこもること。
ヒキザン	ある数から他の数を引いて残った数を求める計算。
ヒキシオ	潮が引いて海水の水位が低くなり、海岸線が沖に退いていく現象。下げ潮。
ヒキダシ	物をしまっておくために、机やたんすなどに付いている、出し入れのできる箱。
ヒキド	左右に引いて開閉する戸。
ヒキニク	器械でひいて細かくした肉。
ヒキヨリ	ボールが飛んだ距離。
ヒキワケ	勝負がつかないまま、やめること。ドロー。
ヒグレ	太陽がしずもうとしているころ。
ヒケツ	提出された議案を不賛成または不承認と議決すること。
ヒゲ	人や動物の、口やあごのまわりに生える毛。
ヒゲキ	世の中の悲しみやあわれをえげき、悲しい結末で終わるしばい。不幸で悲しい出来事。
ヒゲヅラ	ひげの生えた顔。
ヒコウ	空中を飛ぶこと。
ヒコウカイ	一般の人には公開しないこと。
ヒコウキ	プロペラの回転や燃焼ガスの噴射によって空を飛ぶ乗り物。
ヒコウシ	飛行機を操縦する人。パイロット。
ヒコウシキ	公式ではないこと。表向きではないこと。
ヒゴ	竹を細く割って削ったもの。ちょうちん・かごの材料などに用いる。
ヒサク	秘密のはかりごと。ひそかに立てたうまい策略。
ヒザ	ももとすねをつなぐ、足を曲げる関節の前の部分。
ヒザカケ	防寒用・保温用として、ひざの上にかける毛布や布。
ヒザシ	日の光。日光がてること。
ヒザマクラ	他の人のひざを枕にすること。
ヒシガタ	四辺の長さが等しく、四つの角が直角でない四辺形。
ヒシモチ	ひし形に切ったもち。ひな祭りで供える。
ヒシヨ	大事な仕事をする人のそばにいて、その人を助ける働きをする人。
ヒジ	うでを曲げたり、のばしたりする関節。
ヒジカケ	いすなどの、ひじをもたせかける部分。
ヒジマクラ	自分のひじを曲げて枕の代わりにすること。
ヒズミ	形や体積の変化。のび・ちぢみ・ねじれ・ゆがみなど。
ヒゾウ	非常に大切なものとして、しまっておくこと。
ヒタイ	かみのはえぎわから、まゆまでの間。おでこ。
ヒダ	細く折りたたんだように見える、しわ状のもの。
ヒダイ	太って大きくなること。正常な大きさよりも大きくなること。
ヒダマリ	日当たりがよくて暖かい所。
ヒダリ	そのものが東を向いたときの北の方向。
ヒダリウデ	左側の腕。さわん。
ヒダリキキ	右手よりも左手のほうがよく利くこと。
ヒダリテ	左の手。左側。
ヒツアツ	文字を書くとき、筆・ペンなどの筆記用具の先に加わる力。
ヒツキ	書き記すこと。
ヒツケヤク	事件・論議・改革などのきっかけを作る役。
ヒツケン	必ず見なくてはならないこと。見る価値のあるもの。
ヒツコシ	移転。転居。
ヒツサン	数字を紙に書いて計算すること。
ヒツシヤ	書いた人。作者。
ヒツシユウ	必ず学ばなくてはならないこと。
ヒツシヨウ	必ず勝つこと。
ヒツジ	全身がふさふさした毛でおおわれている動物。羊毛がとれる。
ヒツス	どうしても必要なこと。なくてはならないこと。
ヒツセキ	書かれた文字。また、その文字の特徴や書きぐせ。
ヒツゼン	必ずそうなること。偶然の反対。
ヒツダン	互いに文字を書いて意思を伝え合うこと。
ヒツチヤク	期日までに必ず着くこと。
ヒツテキ	比べたとき、価値・能力などが同程度であること。
ヒツドク	必ず読まなくてはならないこと。読む価値のあるもの。
ヒツヨウ	必ず要ること。どうしてもしなければならないこと。
ヒヅケ	書類・手紙などに記す、作成・提出などの年月日。年月日を示す数字。
ヒヅメ	馬・牛・羊などの足先にあるかたい角質のつめ。
ヒデリ	日が照ること。晴天が続いて雨が降らないこと。
ヒト	人間。
ヒトイキ	一回の呼吸。ちょっと休むこと。ひと休み。
ヒトカゲ	人の姿。物に映った人の影。
ヒトガラ	その人に備わっている性格や品格。
ヒトクチ	口に入る一回分だけ飲食すること。また、その口に入る量。
ヒトケ	人のけはい。人がいそうな様子。
ヒトコト	一つの言葉。短い言葉。
ヒトコマ	映画・演劇・漫画などの一場面。
ヒトゴト	自分とは関係ないこと。
ヒトゴミ	多くの人がいて、込み合っていること。また、その場所。雑踏。
ヒトサマ	他人の敬称。
ヒトジチ	要求を押し通すために拘束しておく相手側の人。
ヒトダスケ	困っている人を助けること。
ヒトチガイ	別の人をある人と思い違いすること。
ヒトツキ	一か月。
ヒトヅカイ	人の使い方。
ヒトヅマ	結婚して夫のある女性。他人の妻。
ヒトデ	働く人の数。他の人の助け。
ヒトネムリ	しばらくの間眠ること。
ヒトハダ	人間のはだ。また、それくらいの温かさ。
ヒトバン	夕方から朝までの時間。
ヒトビト	たくさんの人のこと。
ヒトマエ	他人の人が見ている前。
ヒトマカセ	他人にすっかり任せること。
ヒトマトメ	一つにまとめること。
ヒトミシリ	子供などが知らない人を見ておじけづいたり嫌ったりすること。
ヒトメ	一度だけ見ること。ちょっと見ること。
ヒトモウケ	一度にまとまった利益を得ること。
ヒトモジ	大勢の人が並んで文字の形を作ること。また、その文字。
ヒトヤスミ	途中で少し休むこと。
ヒトリゴト	聞く相手がいないのに、独りでものを言うこと。
ヒトリジメ	その人一人だけで自分のものにしてしまうこと。独占。
ヒドケイ	時計の一種。垂直に立てた指針の影の指す目盛りで時刻を知る装置。
ヒナ	卵からかえってまもない鳥の子。
ヒナタ	日光が当たっている場所。
ヒナマツリ	三月三日の節句にひな人形や調度品を飾り、女児の幸せを祈る行事。
ヒノクルマ	家計がきわめて苦しいこと。
ヒノタマ	球状になった火のかたまり。
ヒノテ	火事などで、燃え上がる炎。
ヒノデ	太陽が東の空に出てくること。
ヒノマル	白地に赤い丸をかいたもの。日章旗。
ヒハン	物事のよしあしについて評価すること。
ヒバナ	石や金属などがぶつかったときに出る火。放電のときに出る光。
ヒヒヨウ	物事の良し悪し・価値などについて考えを述べること。
ヒビ	表面にできた裂け目や割れ目。
ヒビキ	音がひびくこと。また、その音。
ヒフ	動物の体をおおっている皮。
ヒヘン	「明」「時」「晴」などの漢字の左側の部首。
ヒボシ	直接日光に当てて干すこと。
ヒマ	何かをするために必要な時間。空いていて自由に使える時間。
ヒマゴ	孫の子。ひいまご。
ヒマツブシ	ひまな時間を何かをしてすごすこと。
ヒマワリ	夏、大きな黄色の花をさかせる草花。
ヒマン	体が普通以上に太っていること。
ヒミツ	かくしていて人に知らせないこと。または、その内容。
ヒメイ	おどろいたとき、おそろしいときに出す、さけび声。
ヒモ	物をしばるときに使う、細いつな。
ヒモチ	食べ物などが日数を経ても変質しないこと。また、その度合い。
ヒモノ	魚や貝などを干した食べ物。
ヒヤアセ	はずかしいときやこわいときに出る冷たい汗。
ヒヤク	十の十倍。とても多いこと。
ヒヤケ	強い日ざしを受けて皮膚が褐色に変わること。
ヒヤトイ	一日単位の契約で雇うこと。また、その雇われた人。
ヒヤミズ	冷たい水。れいすい。
ヒヤメシ	冷たくなった飯。
ヒヤヤツコ	冷やした豆腐を醤油と薬味をつけて食べる料理。
ヒヨウ	何かの目的のためにかかるお金。
ヒヨウカ	物の値段、良し悪しなどを決めること。
ヒヨウガ	万年雪が氷となり、下の方へ動いていくもの。
ヒヨウキ	文字や記号を使って言葉を書き記すこと。
ヒヨウケイ	敬意を表すこと。
ヒヨウゲン	感情や考えを色や形、言葉や音で表すこと。
ヒヨウコウ	ある地点の平均海水面を基準とした、ある場所の高さ。
ヒヨウサツ	居住者の氏名を記して戸口や門に掲げておく札。
ヒヨウザン	南極や北極の海に浮かんでいる氷のかたまり。
ヒヨウシキ	ある事柄を知らせるための目印。目印として設置されたもの。
ヒヨウジ	表し示すこと。
ヒヨウセツ	氷と雪。
ヒヨウテキ	まと。攻撃目標。ターゲット。
ヒヨウハク	日光や薬品などで脱色させて白くすること。
ヒヨウバン	人の批評。名高いこと。有名なこと。世間のうわさ。
ヒヨウメイ	自分の考えや決意をはっきりとあらわし示すこと。
ヒヨウロン	物事の善悪・優劣・価値などについて批評して論じること。また、その文章。
ヒヨケ	直射日光をさえぎるためのおおい。日傘。パラソル。
ヒヨコ	鳥の子ども。とくににわとりの子。
ヒヨリミ	天候の様子を見ること。有利な方につこうとして形勢をうかがうこと。
ヒライ	飛んで来ること。
ヒライシン	落雷による被害を防ぐために建造物の上などに立てる金属の棒。
ヒラオヨギ	泳法の一つ。体を下向きにし、両手を左右対称に開きながら水をかき、足はカエル足を用いて進む。
ヒラガナ	平安初期に成立したわが国独特の音節文字の一つ。
ヒラテ	開いた手のひら。
ヒラメ	平べったい魚の一種で、頭部の左側に両目があるもの。
ヒラヤ	一階建ての家。
ヒリツ	二つ以上の数量を比較したときの割合。
ヒリヨウ	農作物の成長を進めるために耕地にあたえる栄養分。
ヒル	日の出から日の入りまでの間。正午、または正午すぎ。
ヒルゴハン	昼の食事。
ヒルサガリ	正午を少し過ぎたころ。
ヒルスギ	正午を過ぎたころ。午後。
ヒルネ	昼間寝ること。
ヒルマ	朝から夕方までの間。昼の間。
ヒルマエ	正午の少し前。午前。
ヒルメシ	昼の食事。昼食。
ヒルヤスミ	昼食時にとる休憩。また、その時間。
ヒレ	魚類や水生哺乳類が遊泳するための運動器官。
ヒロウ	疲れて元気がなくなること。
ヒロバ	広く空いている場所。
ヒロマ	広い部屋・座敷。
ヒワ	世間の人々に知られていない話。
ヒンカク	その人や物から感じられる品のよさ。品位。
ヒンケツ	血液、とくに赤血球が足りないこと。
ヒンシツ	品物の質。
ヒンシユ	同一種の農作物や家畜を形質の違いで分類した種類。「○○○○改良」
ヒント	問題を解く手がかり。
ヒンド	ある事が繰り返して起こる度合い。
ヒンパツ	同じ種類のことがしきりに起こること。
ヒンプ	貧しいことと富んでいること。貧乏人と金持ち。
ヒーター	暖房装置。暖房器具。電熱器。
ビエン	鼻の穴の粘膜の炎症。
ビカ	実際以上に美しく考えること。実際以上に美しく表現すること。
ビギナー	初心者。
ビケイ	美しい容貌。美女、美男。
ビコウ	相手に見つからないように人の後をつけていくこと。
ビシヨヌレ	びしょびしょにぬれること。ずぶぬれ。
ビジネス	仕事。職業。事業。利益を上げる手段としての仕事。
ビジユツ	色彩や形によって美しさを表そうとする芸術。
ビジヨ	容姿の美しい女性。美人。
ビジン	顔立ちの美しい女の人。
ビスケツト	小麦粉に牛乳・油脂・卵・砂糖などを混ぜてこね、一定の形に抜いて固めに焼いた菓子。
ビセイ	美しい声。
ビセイブツ	顕微鏡でなければ見えないたいへん小さな生物。
ビタミン	生体の発育と健康維持に不可欠な有機化合物の総称。
ビダンシ	容姿の美しい男子。びなんし。
ビチク	将来の使用や万一の場合に備えてたくわえておくこと。また、そのたくわえ。
ビデオ	テレビの映像。
ビネツ	軽微な発熱。平熱より少し高い体温。
ビハダ	色つやの美しい肌。また、肌を美しくすること。
ビヒン	会社・学校などで必要なものとして備え付けてある品物。
ビボウ	美しい顔かたち。
ビミ	味がよいこと。また、うまい飲食物。
ビヨウ	容姿・肌などを美しくすること。
ビヨウイン	病人やけが人の診察や治療をする施設。
ビヨウシヤ	対象を描き出すこと。客観的に描き写すこと。
ビヨウシン	時計の秒を指す針。
ビヨウソク	一秒間に進む距離で表した速さ。
ビヨウドウ	差別することなく、同じように扱うこと。
ビヨウニン	病気にかかっている人。
ビヨウメイ	病気の名称。
ビヨク	飛行機などの後ろの方の翼。
ビラ	広告・宣伝のために文字や絵をかいてはり出したり、人に配る紙。
ビリユウシ	きわめて細かいつぶ。
ビリヨウ	きわめてわずかな量。
ビル	鉄筋コンクリートなどで建てられた高く大きな建物。
ビン	交通・輸送機関の運行・輸送。手紙。たより。
ビンジヨウ	自分に都合のよい機会をとらえてうまく利用すること。
ビンセン	手紙を書くための用紙。
ビーカー	理科の実験に使う、透明なコップのような入れ物。
ビーダマ	子供が遊びに使う小さなガラス玉。
ビール	大麦から作る発泡酒。
ピアス	耳たぶに小さな穴を開けてつけるイヤリング。
ピアニスト	ピアノの演奏家。
ピアノ	白と黒のけんばんをたたいて音を出す楽器。
ピザ	イタリア料理の一つ。平たくのばしたパン生地にトマトソースを塗り、好みの具を乗せてオーブンで焼いたもの。ピッツァ。
ピラミツド	エジプトなどに残る、石を四角すいに積み上げた巨大な建造物。金字塔。
ピント	カメラなどのレンズの焦点。フォーカス。「○○○を合わせる」
ピンボケ	ピントがはずれて画像がぼけること。
ピーナツツ	落花生の実。ピーナツ。
フア	ドレミのミの次の音。
フアツクス	画像を電気信号に変えて電話回線で送り、受信側でその画像を再現する通信方式や装置。ファクシミリ。
フイアンセ	婚約者。いいなずけ。
フイツト	型やサイズがぴったり合うこと。
フイルター	液体や気体の中の固体粒子を分離させる装置。ろ過器。ろ過装置。
フウ	封筒・容器・出入り口などを閉じてふさぐこと。
フウアツ	風が物体に与える圧力。
フウウ	雨と風。また、風をともなった雨。
フウガワリ	様子・性質・行動などが一般と違っていること。
フウケイ	自然のながめ。その場の様子。
フウサ	出入りまたは出し入れできないように閉ざすこと。
フウシヤ	風を受けて回転する羽根車。また、その羽根車から動力を得る装置。
フウシユウ	むかしから伝わっている、生活の仕方やならわし。
フウセン	紙やゴムのふくろの中に、息やガスなどを入れてふくらませた物。
フウソク	風の吹く速さ。
フウチヨウ	時代とともに変化する世の中の傾向。
フウトウ	手紙や書類などを入れる紙のふくろ。
フウド	その土地の気候・地形・地質など、住民の生活・文化に影響を及ぼす自然環境。
フウバイカ	風の媒介によって受粉する花。
フウフ	結婚した男女の一組。夫と妻。
フウブツシ	景色または季節を詠んだ詩。
フウミ	食べ物の味わい。
フウリユウ	優雅で落ち着いたおもむきがあること。
フウリヨク	風が物体に及ぼす力。風の持つエネルギー。
フウリン	金属・陶器・ガラスなどで作ったつりがね形の小さなすず。
フエ	木や金属の管に、息をふきこんで鳴らす楽器。
フオアグラ	強制的に肥育したガチョウの肥大した肝臓。
フオーク	西洋料理で食べ物を刺して口へ運ぶのに使う金属製の用具。
フカ	卵がかえること。卵をかえすこと。
フカイリ	必要以上に深くかかわりあうこと。
フカカイ	理解に苦しむこと。
フカカチ	企業が新たに作り出した価値。
フカケツ	なくてはならないもの。
フカヅメ	つめを深く切ること。
フカヒ	避けようがないこと。必ず起こること。
フカヒレ	中国料理の食材の一つ。サメのひれの外皮を取り去って日干しにしたもの。
フカミ	川や海、池などの深い所。簡単にはぬけ出せない状況。
フカヨミ	他人の表現・言動などに込められた意味を必要以上に深く解釈すること。
フキ	キク科の多年草。花茎は「○○のとう」と呼ばれる。
フキカエ	外国映画などのせりふを自国語に訳して録音しなおすこと。
フキソ	検察官が公訴を提起しない処分。
フキソウジ	雑巾などでふいてきれいにすること。
フキソク	一定の決まりに従っていないこと。規則的でないこと。
フキノトウ	早春、フキの根茎から生え出る花茎。食用。
フキヤ	細長い筒の中に小さな矢を入れ、強く息を吹き込んで飛ばすもの。また、その矢。
フキユウ	広く行きわたること。
フキン	机の上や食器をふく小さな布。
フク	きもの。洋服。
フクエン	離婚した夫婦、離縁した養子などが再びもとの関係に戻ること。
フクガン	多数の個眼により形成される眼。昆虫類・甲殻類などにみられる。
フクギヨウ	本業のかたわらにする仕事。
フクゲン	もとの位置や形態に戻すこと。また、戻ること。
フクゴウ	二つ以上のものが合わさって一つのものになること。
フクサヨウ	薬物が病気を治療する作用以外に人体に及ぼす作用。
フクザツ	こみ入っているさま。ややこしいさま。
フクシ	国家によって国民に等しく保障されるべき安定した生活および社会環境。
フクシヤ	機械で原稿などを同じ状態になるように写すこと。コピー。
フクシユウ	一度習ったことを繰り返して勉強すること。おさらい。
フクスウ	数が二つ以上であること。
フクセイ	ある物とそっくりな物を別に作ること。また、その作られた物。
フクソウ	衣服を身に付けたときの様子。よそおい。
フクダイ	サブタイトル。
フクツ	困難にくじけないで意志を貫くこと。
フクノカミ	福をもたらすという神。七福神。
フクビキ	くじを引かせて、当たった人に賞品を分け与えること。また、そのくじ。
フクブ	動物の腹の部分。おなか。
フクブクロ	商店の初売りなどで売られる、いろいろな品物を入れた袋。
フクミミ	耳たぶの大きい耳。
フクヤク	薬を飲むこと。服用。
フクヨウ	薬を飲むこと。服薬。
フクラシコ	ベーキングパウダー。
フクラハギ	すねの後ろの筋肉のふくらんだ部分。
フクロ	一方に口があって、それを閉じることができるように作った紙・布・皮などの入れ物。
フグ	海魚の一種。多くは肝臓・卵巣に猛毒を持つが肉は美味。ふく。かとん。
フゲン	口に出して言わないこと。「○○○実行」
フゴウ	きわめて富んでいる人。大金持ち。
フサ	花や実が多く集まって枝から垂れ下がっているもの。
フサイ	夫と妻。夫婦。
フザイ	その人がその場所にいないこと。
フシ	盛り上がっていて区切りになっているところ。
フシアナ	板などの節の部分が抜け落ちたあとの穴。
フシギ	どうしてなのか原因がわからないさま。
フシン	信じないこと。信用できないこと。「人間○○○」
フジサン	日本一高い山。高さは三七七六メートル。
フジチヤク	飛行機が故障・悪天候などのために目的地以外の場所に降りること。
フジミ	何があっても死なないこと。
フジヨ	婦人。女性。
フジヨウ	浮かび上がること。表面に現れること。順位が上がってくること。
フジン	他人の妻の敬称。
フスウ	ゼロより小さい数。負の数。マイナスの数。
フスマ	和室の建具の一つ。木で枠を組み、両面に布・紙などをはり合わせたもの。部屋の仕切り。
フゼイ	風雅な趣。風流な味わい。情緒。
フソク	足りないこと。十分でないこと。
フゾク	主なものに付いていること。主なものに付けて作られたもの。
フゾロイ	そろっていないこと。大きさ・形・種類などがまちまちであること。組になっていないこと。
フタ	入れ物などの口にあてがって、ふさぐもの。
フタエ	二つ重なっていること。にじゅう。
フタゴ	同じ母親から一度に生まれた二人の子ども。
フタツオリ	真ん中から二つに折ること。
フタバ	植物が発芽したときに見られる二枚の子葉。
フタン	引き受けること。金銭や責任、仕事の重荷。
フチ	物のまわりの部分。へり。物の端っこ。
フチドリ	物の周囲やへりに飾りをつけること。
フチヤク	ある物が別の物にくっつくこと。
フツカ	その月の二番目の日。一日の二倍。
フツカツ	死んだ者がよみがえること。おとろえたものが元の状態に戻ること。
フツカヨイ	酒の酔いが翌日まで持ち越されて気分がよくないこと。
フツキ	もとの地位・任務・状態などに戻ること。
フツキユウ	壊れたものなどが、もとの状態に戻ること。もとの状態に戻すこと。
フツキン	お腹まわりの筋肉。腹壁を作る筋肉の総称。
フツコウ	一度衰えたものが再び盛んになること。盛んにすること。
フツテン	液体が沸騰する温度。
フツトウ	煮えくり返ること。わき立つこと。
フテイキ	時期・期間などが一定していないこと。
フデ	竹や木の柄の先に、束ねた獣毛を付け、墨や絵の具などを含ませて文字や絵をかく道具。
フデヅカイ	筆の使い方。筆の運び。
フデバコ	鉛筆や消しゴム、ペンなどの筆記用具を入れる箱。
フトウコウ	児童・生徒が心理的な理由などから登校しないこと。
フトウメイ	すきとおっていないこと。
フトクテイ	特にこれと定まっていないこと。
フトコロ	着物と胸の間。懐中。
フトツパラ	太った腹。大胆なこと。度量の大きいこと。
フトモモ	ももの内側のふくらんだ部分。
フトン	布の袋の中にわたなどを入れて、ねるときやすわるときに使う物。
フドウ	動かないこと。「○○○明王」
フドウサン	土地と、その定着物である建物など。
フドウタイ	熱または電気が伝わりにくい物体。絶縁体。
フナ	コイ科の淡水魚。コイに似ているが、小形でひげがない。食用。
フナウタ	船頭、水夫などが、船をこぎながらうたう歌。さおうた。
フナカ	中がよくないこと。
フナゾコ	船の底。
フナデ	船が港を出ること。出航。出帆。
フナヨイ	船に乗った人が、船のゆれで一時的に気分が悪くなること。
フナレ	なれていないこと。
フネ	水にうくように作った乗り物。
フブキ	強い風に吹かれて雪が激しく乱れ飛びながら降ること。
フホンイ	自分の本当の気持ちとは異なること。
フボ	父と母。両親。
フミキリ	線路と道路が交わっている所。飛ぶ瞬間に強くける場所や瞬間。
フモン	あえて問いたださないこと。問題にしないこと。
フユ	四季の一つで、もっとも寒い季節。
フヨウド	堆積した落ち葉が腐ってできた土。養分が多い。
フライ	魚介・肉・野菜などに小麦粉・溶き卵・パン粉をまぶして油で揚げたもの。
フラスコ	理科実験に使う首の長い透明な入れ物。
フラダンス	ハワイの民族舞踊。
フランス	ワインで有名なヨーロッパ西部の国。大西洋と地中海に面する。
フリカケ	飯の上に振りかけて食べる食品。
フリガナ	漢字の読みを漢字のそばに書いた仮名。
フリコ	重力の作用でつり下げた重りが左右にゆれ動くようにした仕かけ。
フリダシ	すごろくの出発点。物事の最初の状態。
フリツケ	音楽や歌に合わせた踊りを考案して教えること。
フリヨク	気体や液体の中で物が上におし上げられる力。浮こうとする力。
フルイ	浅い枠の底に金網・絹布などを張った道具。細かいものと粗いものをより分ける。
フルギ	着古した衣類。
フルサト	自分の生まれ育った土地。故郷。
フルホン	古くなった本。
フルーツ	英語で果物のこと。
フルート	清澄で華麗な音色の横笛。現在は金属製のものが多い。
フロ	体を洗ったり、あたためたりするための、湯の入った湯ぶね。
フロク	雑誌などで主なものの他に、付け加えているもの。おまけ。
フロシキ	物を包んで運ぶための四角い布のこと。
フロント	正面。前面。ホテルなどの受付。
フンイキ	人が集まった場所の様子や気分など。
フンカ	火山が爆発して、火口から溶岩やガスをふき出すこと。
フンカコウ	火山が溶岩・火山弾・火山灰などを噴き出す口。
フンシヤ	勢いよく噴き出させること。
フンスイ	水が噴き出るように作った装置。
フンマツ	固体を砕いて細かくしたもの。粉状のもの。
ブイン	その部に属している人。
ブカ	同じ団体の中で、上の人の命令や指図を受けて働く人。
ブカツ	学生や生徒のクラブ活動。
ブキ	戦いに用いる道具。
ブザー	電磁石によって鉄片を振動させて音を出す装置。
ブシ	昔、武芸を修め、軍事にたずさわった者。さむらい。もののふ。
ブシユ	へん・つくり・かんむりなどの漢字の部分のこと。
ブジ	悪いことなどが起こらないさま。健康でいるさま。
ブスウ	書籍・新聞・雑誌などの数。
ブタ	食肉用にイノシシを改良した家畜。
ブタイ	軍隊の一部を構成する隊。
ブタニク	食用としての豚の肉。
ブチヨウ	部の長。
ブツカ	いろいろな物の値段。
ブツキヨウ	釈迦がインドで説いた教えに基づいて成立した宗教。
ブツギリ	料理で、材料を形にとらわれないで大きめに切ること。
ブツケン	土地・建物などの不動産。「優良○○○○」
ブツシ	食料・衣服などの生活で使われる品物。
ブツシツ	見たりさわったりしてそこにあることがわかるもの。
ブツゾウ	仏の彫刻・画像。
ブツタイ	空間の中に存在している物。
ブツダン	仏像・位牌などを安置する壇（だん）。正面に両開きの扉がある。
ブツリガク	物質の構造・性質を探求し、自然現象を支配する普遍的な法則を研究する学問。
ブツリユウ	生産物が生産者から消費者の手に渡るまでの流れ。
ブトウ	踊りをおどること。舞いおどること。ダンス。
ブドウ	いくつもの丸い実をつける果物。
ブヒン	機械や道具を組み立てている一つ一つの部分。
ブブン	物事の全体を小さく分けた一つ一つ。
ブラシ	ほこりやよごれをこすって取るための道具。
ブランコ	つり下げた日本の綱・鎖の下端に腰をかける横板を取り付けた遊具。
ブリ	代表的な出世魚。大型の近海魚。「ワカシ→イナダ→ワラサ→○○」
ブリキ	薄い鉄板にすずをめっきしたもの。
ブン	思ったことや感じたことを文字で書き表したもの。
ブンカ	人間の精神の働きによって作り出され、人間生活を高めていく上の新しい価値を生み出すもの。
ブンカイ	一つのまとまったものを細かく、ばらばらにすること。
ブンカツ	いくつかに分けること。
ブンカノヒ	国民の祝日の一つ。十一月三日。
ブンガク	言語で表現される芸術作品。
ブンキ	二つの方向に分かれること。
ブンキテン	道路・線路などが二つの方向に分かれる点。
ブング	文房具。
ブンケン	権力を分散させること。
ブンゴウ	きわめてすぐれた文学者。
ブンサン	分かれて、ばらばらに散ること。
ブンシユウ	いろいろな文章を集めて本にしたもの。
ブンシヨ	文字で書き記したもの。書類。
ブンシヨウ	文字を使って、まとまった考えや気持ちを書き表したもの。
ブンセキ	複雑な事柄を細かな要素に分けて、その性質・構造などを明らかにすること。
ブンタン	仕事などをいくつかに分けて受け持つこと。
ブンダン	一つにつながっているものを、断ち切って別々に分けること。
ブンチン	紙・書類などの重しとして、上に乗せる文具。
ブンツウ	手紙をやり取りすること。
ブンドキ	角度をはかるための器具。
ブンベツ	種類によって区分・区別すること。「ゴミの○○○○」
ブンボウグ	物を書くときに必要な道具。文具。
ブンポウ	単語や文章の、組み立てやはたらきの決まり。
ブンマツ	文の終わりの部分。
ブンメイ	人間の知識や技術が向上し、物質的・精神的に生活が豊かになった状態。
ブンヤ	人間が活動する範囲。いくつかに分かれているそれぞれの領域。
ブンリ	分かれて離れること。
ブンルイ	種類や性質、働きなどのちがいによって分けること。
ブンレツ	一つにまとまっていたものがいくつかに分かれること。
ブーム	急に人気が出ること。
プライド	英語で自分をすぐれていると思う心。
プラチナ	白金。
プラモデル	プラスチック製の部品を組み立てて作る模型のおもちゃ。
プリン	プディング。特にカスタードプディング。
プリント	印刷すること。
プレゼント	贈り物。
プロ	そのことを職業にしている人。
プール	人工的に作られた水泳場。
ヘイアン	何も変わったことがなく、無事であること。
ヘイカイ	会議・集会などが終わること。また、終えること。
ヘイサ	人を通さないように出入り口を閉ざすこと。閉じてやめること。
ヘイシヤ	自分の会社をへりくだっていう言葉。
ヘイジツ	日曜・祝祭日以外の日。
ヘイセイ	昭和の次の年号。
ヘイチ	平らな土地。
ヘイテン	店を閉めること。
ヘイネツ	健康なときの体温。
ヘイボン	ごく普通で、特にすぐれたところ、変わったところがないこと。
ヘイマク	舞台の幕が下りて芝居などが終わること。行事などが終わること。
ヘイメン	曲がっていない平らな面。
ヘイメンズ	物体を真上から見た図。
ヘイヨウ	二つ以上のものをいっしょに使うこと。
ヘイワ	戦いがなく、おだやかなさま。
ヘキガ	壁面・天井などに描かれた絵画。
ヘキメン	壁の表面。
ヘソ	腹の真ん中にある小さなくぼみ。
ヘソノオ	胎児のへそと母体の胎盤をつなぐ管状の器官。さい帯。
ヘタ	物事のやり方、仕方、技術、仕上がりなどがまずいこと。
ヘタクソ	きわめて下手なこと。また、そのような人。
ヘチマ	ウリの仲間の植物。実は太く長く、たわしやあかすりにする。
ヘツドホン	頭にかけ、両耳にあてて使う小型のスピーカー。
ヘビ	はちゅう類の一種で、体が細長く、足がない動物。
ヘヤ	家の中をいくつかに仕切った所。相撲の力士が属するところ。
ヘラ	竹・木・金属などを細長く平たくし、先端を刃のようにとがらせた道具。
ヘリ	物のまわりの部分。物のはし。ふち。
ヘリポート	ヘリコプターの離着陸に使う施設。ヘリの発着所。
ヘルメツト	頭部を衝撃から守るためにかぶる、丈夫な帽子。
ヘンアツ	圧力を変えること。電圧を変えること。
ヘンカ	性質や様子が変わること。
ヘンキヤク	借りていた物、預かっていた物などを所有者に返すこと。
ヘンケイ	形を変えること。
ヘンコウ	決められていた事柄を変えること。
ヘンサイ	借りた金銭や品物を相手に返すこと。
ヘンシユウ	原稿などを作ったり、整理したりして本や新聞などにすること。
ヘンシヨク	色が変わること。色を変えること。
ヘンシン	通信手段によって返事をすること。
ヘンジ	答えること。または、答えの言葉や手紙などのこと。
ヘンズツウ	発作的に頭部の片側に起こる激しい頭痛。
ヘンセイキ	声変わりの起こる時期。
ヘンソウ	別人に見せかけるように顔や服装を変えること。
ヘンピン	買った品物や仕入れた品物を返すこと。
ベイコク	アメリカ合衆国のこと。アメリカ。
ベイジユ	数え年八十八歳。またその祝い。
ベツカン	本館とは別に建てられた建物。
ベツシツ	他の部屋。また、特別な部屋。
ベツシヨウ	別の呼び名。別の名称。
ベツジン	別の人。他の人。
ベツソウ	本宅とは別の土地に設けた家。
ベツド	寝台。ねどこ。
ベテラン	英語で長く経験をつんで、すぐれた技術を持っている人のこと。
ベニ	鮮やかな赤色。
ベニアイタ	薄い板材を二枚以上はり合わせた板。合板。
ベビー	赤ん坊。乳児。小さいもの。
ベンキヨウ	学習にはげむこと。学ぶこと。
ベンゴ	その人の利益になることを主張して、その人を守ること。
ベンゴシ	訴訟行為や法律事務を行うことを職業とする人。
ベンシヨウ	他人に与えた損害を金銭や品物で埋め合わせすること。
ベンチ	駅・公園などに備えてある長細い椅子。
ベントウ	外出先で食べられるように食べ物を詰めた箱。
ベンリ	都合がいいさま。役に立つさま。
ベーコン	豚のばら肉を塩漬けにしてからくん製にした食品。
ペア	二つでひとそろいになること。二人で一組になること。
ペイント	着色や表面保護のため、物の表面に塗布する材料の総称。ペンキ。
ペキン	中華人民共和国の首都。
ペダル	いろいろな機械を操作するために足でふむ板状のもの。
ペツト	愛玩用の動物。
ペンキ	物に色をぬりつけるための塗料。
ペンギン	南極に住む、背中が黒い鳥。泳ぎは上手だが、空は飛べない。
ペンチ	針金やブリキなどを曲げたり、切ったりする道具。
ページ	書物・ノートなどの紙の一面。またその順序を示す数字。
ホイク	乳幼児を保護し育てること。
ホイツスル	競技で、審判などが合図のために鳴らす小型の笛。
ホウ	決まり。法律。法則。方法。
ホウアン	法律の案。
ホウカ	わざと家に火を付けて火事を起こすこと。
ホウカゴ	学校の授業が終わった後。
ホウガク	東西南北の向き。
ホウガンシ	直角に交わる縦横の線を等間隔に引いた用紙。
ホウキ	ごみやちりなどを掃いて取り除く用具。
ホウゲン	ある地方で使われている、標準語でない言葉。
ホウコク	告げ知らせること。
ホウサク	農作物がよく育って収穫量が多いこと。満作。
ホウシン	目指す方向ややり方。
ホウスイ	ホースなどから水を勢いよく出すこと。
ホウセキ	美しくて貴重な鉱物。
ホウソウ	電波でラジオやテレビの番組を送ること。
ホウソク	ある条件のもとで、いつも成り立つ決まり。
ホウタイ	傷口などを保護するために巻き付ける細長い布。
ホウチ	置きっぱなしにしておくこと。
ホウチヨウ	料理に使う刃物。
ホウテイ	裁判所が審理・裁判を行う場所。
ホウデン	帯電体が電気を失うこと。蓄電池から電流が流れ出すこと。
ホウドウ	大勢に告げ知らせること。
ホウネツ	熱を放散すること。
ホウビ	ほめるために与える金品。
ホウフ	豊かでたくさんあるさま。
ホウホウ	目的を達成するためのやり方。手立て。
ホウモン	人を訪ねること。他の家・他国などを訪れること。
ホウリツ	国民が安全に生活できるように国が決めた決まり。法令。
ホウリユウ	水を放出すること。
ホウレイ	法律と命令。
ホウロウ	あてもなくさまよい歩くこと。定住しないでさすらうこと。
ホオ	口と鼻と耳の間の柔らかい部分。ほほ。ほっぺ。ほっぺた。
ホオズリ	自分のほおを相手のほおにすりつけること。
ホオヅエ	ひじをついて手のひらでほおを支えること。
ホオン	温度が下がらないように保つこと。
ホカク	動物などを捕らえること。生け捕ること。
ホカケブネ	帆をはって走る船。
ホカン	物品を預かって保存・管理しておくこと。
ホキユウ	足りなくなった分を補うこと。「水分○○○○」
ホキヨウ	弱いところを補って強くすること。
ホクイ	赤道より北の緯度。
ホクジヨウ	北へ向かって進むこと。
ホクセイ	北と西の中間の方角。
ホクトウ	北と東の中間の方角。
ホクブ	ある地域の中で、北の方の部分。
ホクベイ	北アメリカのこと。カナダとアメリカ合衆国のこと。
ホクロ	ひふにできる小さな黒いはん点。
ホケツ	欠員を補うこと。また、そのための予備の人員。
ホケン	健康を守り保つこと。
ホコウ	歩くこと。
ホコリ	空中をとびちり、物にくっついてたまる細かなごみ。
ホゴ	害を受けないようにかばい、守ること。
ホゴシヤ	児童など未成年者を保護する義務のある人。
ホシ	夜空に小さく光って見える天体。
ホシガキ	渋柿の皮をむき、天日で干して甘みを出したもの。
ホシクサ	家畜のえさにするため、かり取って日に干した草。
ホシブドウ	ブドウの実を乾燥させたもの。レーズン。
ホシユウ	正規の授業以外に、学力を補うために学習すること。
ホシヨウ	ある地位や状態が損なわれないように、保護して守ること。
ホジ	保ち続けること。
ホジヨ	足りないところを補って助けること。また、その助けとなるもの。
ホスウ	歩くときに足で踏む回数。
ホソウ	道の表面をアスファルト・コンクリートなどで固めること。
ホゾン	そのままの状態を保ちながら、とっておくこと。
ホタル	水辺の草むらに住む黒い昆虫。腹の先を光らせて飛ぶ。
ホタルイカ	全身が光るイカ。
ホチヨウキ	難聴者のために、音を大きく増幅させて聞き取りやすくさせる装置。
ホツキヨク	地球の一番北のはし。
ホテル	洋式の設備を備えた宿泊施設。西洋風の旅館。
ホドウ	歩行者用の道。人道。
ホネ	動物の体内にある、かたくて白い物。
ホネグミ	体の骨の組み立て。
ホノオ	物が燃えるときに光りかがやく部分。
ホボ	子供の保育に従事する女性職員の通称。女性保育士。
ホユウ	自分のものとして持っていること。
ホラアナ	がけや岩にできている、中が空になった大きな穴。どうくつ。
ホリ	地面を長くほって、水が通るようにしたところ。
ホリデー	休日。祭日。
ホロヨイ	酒を飲んでいくらか酔っていること。また、その状態。
ホン	書物。細長いものを数える言葉。
ホンイ	本当の気持ちや希望。
ホンキ	真剣な気持ちを持つさま。本当だと思うさま。
ホンシヤ	一つの会社がいくつかに分かれているとき、その中心となる事務所。
ホンシユウ	日本列島の主要部をなす最大の島。
ホンシヨ	この本。この書物。
ホンシヨク	それを職としている人。
ホンジツ	今日。この日。
ホンダナ	本を並べてのせて置くための棚。
ホントウ	真実であること。まちがっていないこと。
ホンネ	本当の心の中。
ホンノウ	教えられなくても生まれつき持っている能力や性質。
ホンバン	リハーサル・テストではなく、正式に撮影・放送・録音を行うこと。
ホンミヨウ	本当の名前。実名。
ホンモノ	にせ物や作り物ではない、本当の物。
ホンヤ	本を売る店。書店。
ホンヤク	ある言語で表現された文を別の言語に移し変えて表すこと。
ホンルイダ	ホームランを日本語でいうと…。
ホース	ビニールやゴムでできている、水などを通す長い管。
ホーム	家。家庭。祖国。本拠地。
ボウ	まっすぐで細長く手に持てるぐらいのもの。
ボウエイ	他からの攻撃を防ぎ、守ること。
ボウエキ	外国と商品の取引をすること。交易。
ボウカ	火災の発生や延焼を防ぐこと。
ボウカン	寒さを防ぐこと。
ボウキヤク	忘れてしまうこと。
ボウギヨ	敵の攻撃などを防ぎ守ること。
ボウグ	危険を防ぐために身をおおう道具。
ボウグラフ	数量の大きさを棒線の長さで示したグラフ。
ボウケン	思い切って危ないことをやったり、危ない場所に行ったりすること。
ボウコウ	腎臓からの尿を一時たくわえておく袋状の臓器。
ボウサイ	災害を防ぐこと。
ボウシ	頭にかぶるもの。
ボウシユウ	悪臭や異臭を防ぐことや、消すこと。
ボウシヨク	度を越してむやみに食べること。
ボウスイ	水がしみこんだり流れ込んだりするのを防ぐこと。
ボウズ	寺の主人である僧。頭に毛がないこと。男の子を呼ぶ言葉。
ボウセキ	糸をつむぐこと。繊維を加工して糸にすること。
ボウセン	棒のようにまっすぐな線。
ボウソウ	規則をやぶって走ること。運転手のいない車が、勝手につっ走ること。
ボウダン	銃弾の貫通を防ぐこと。「○○○○チョッキ」
ボウチユウ	虫の侵入を防ぐこと。
ボウチヨウ	ふくれて大きくなること。
ボウト	暴動を起こした人々。
ボウトク	神聖なもの、清純なものをおかし、けがすこと。
ボウドウ	多くの者が集まって騒動を起こし、社会の秩序や治安を乱すこと。
ボウドク	毒を防ぐこと。特に毒ガスを防ぐこと。「○○○○マスク」
ボウハン	犯罪を防ぐこと。
ボウフウ	被害を出すほどのはげしい風。
ボウフウウ	激しい風を伴った雨。あらし。
ボウメイ	政治上・宗教上などの理由で、外国へ逃げること。
ボウヨミ	文章を、抑揚をつけないで一本調子に読むこと。
ボキ	企業の資本の増減・出納などを一定の形式で記録・計算・整理する記帳法。
ボキン	寄付金などを一般から集めること。
ボク	同等以下の相手に対して男性が自分を指し示す言葉。
ボクシング	両手にグローブをはめた二人が殴り合って、ノックアウトか判定で勝敗を決めるスポーツ。
ボクジユウ	墨をすった汁。墨色の液。
ボクジヨウ	牛・馬・羊などを放牧する設備を備えている場所。まきば。
ボクソウ	家畜の飼料にする草。
ボクトウ	木で作った刀。
ボコウ	卒業した学校。出身校。
ボコク	生まれ育った国。祖国。
ボシ	母と子。
ボシユウ	広く呼びかけて人や作品などを集めること。
ボス	組織などの長。親分。上司。
ボタン	指で押して機械類などを作動・停止させるためのもの。
ボツシユウ	所有物・権利などを強制的に取り上げること。
ボツチヤン	他人の息子の敬称。苦労を知らずに育った男性。
ボツトウ	一つのことに熱中すること。
ボニユウ	母親自身の乳。
ボヤ	少しの範囲が燃えただけの小さな火事。「○○騒ぎ」
ボリユーム	量。音量。巻。
ボルト	機械部品などを締めて固定するための雄ねじ。
ボンサイ	鉢植えで手を加えて育てた、観賞用の小さな樹木。
ボンチ	周囲を山で囲まれた平地。
ボーイ	男の子。少年。
ボート	小さな舟。人がオールでこぐ舟。
ボール	球。まり。料理用の深い入れ物。
ポイント	点。箇所。要点。得点。
ポケツト	洋服などに取り付けた袋状の物入れ。
ポスター	広告・宣伝などのための、文字・写真・絵などを配した貼り紙。
ポスト	道などに置いてある郵便物を集める入れ物。または、郵便受け。
ポツト	注ぎ口のついたつぼ状の容器。魔法瓶。
ポテト	英語でいものこと。
ポーク	豚肉。
マイ	音楽に合わせて体や手足を動かし、さまざまな姿を見せること。
マイアサ	毎日の朝。
マイゴ	連れて来た人とはぐれたり、道に迷ったりした子ども。
マイシユウ	一週間ごと。どの週も。
マイシヨク	食事のたび。食事ごと。
マイスウ	紙・板・皿など、「枚」で数える物の数。
マイソウ	遺体または遺骨を土の中にうめて葬ること。
マイツキ	月ごと。つきづき。
マイド	たびたび。いつも。「○○○ありがとうございます」
マイニチ	いつの日も。日ごと。日々。
マイネン	いつの年も。年ごと。
マエアシ	四本足の動物の、頭部に近い二本の足。
マエガミ	額の前に垂らした髪。
マエダオシ	予定を早めて予算の執行や施策の実施に踏み切ること。
マエバ	口の前の方にある上下四本の歯。
マエバライ	給料・料金などを前もって支払うこと。
マエムキ	正面、または前面を向いていること。
マカロニ	真ん中に穴のあいたイタリアのめん類。
マガオ	まじめな顔つき。
マガリカド	道などが折れ曲がっている角の所。
マキ	燃料用の割り木。たきぎ。
マキガイ	貝がらがうずを巻いたようになっている貝。
マキバ	牛・馬・羊などの家畜を放し飼いにしておく場所。ぼくじょう。
マキモノ	書画を軸に巻いたもの。軸に巻いた反物。巻きずし。
マキワリ	薪（まき）にするために、丸太などを適当な大きさに割ること。
マク	物の表面をおおう薄い皮。「油の○○ができる」
マクアケ	演劇で、幕が開いて演技が始まること。
マクラ	ねるとき、頭をのせる物。
マグマ	地下深くに存在する、鉱物が地熱でどろどろに溶けたもの。
マグレ	偶然に当たること。
マグロ	背中は青黒く、腹は白い、大きな魚の一種。刺身のトロにする。
マコト	うそ・偽りがないこと。
マゴ	自分の産んだ子どもの子ども。
マゴコロ	うそや偽りのない心。
マゴノテ	背中などの、手の届かない所をかくのに使う道具。
マサツ	物をこすり合わせること。
マサユメ	あとで現実となる夢。
マシタ	そのちょうど下。まっすぐ下。
マシン	機械。
マジツク	魔法。手品。
マジメ	真剣であるさま。真心のあるさま。誠実な様子。
マジユツ	魔法。妖術。大掛かりな奇術。
マジヨ	不思議な力をもつ女性。
マス	穀物や酒・油などの量を量る木製、または金属製の器。
マスイ	薬などを使って、体の感覚をまひさせること。
マスク	ほこりやかぜの菌を防ぐために、鼻や口をおおうもの。
マタ	胴から足が出る所。ももとももの間。
マタタビ	山地に生え、夏、白い花を咲かせる植物。猫が好む。
マダム	既婚の女性。夫人。奥様。喫茶店・酒場などの女主人。
マチ	人口が多く、人家が集中している所。
マチカド	街路の曲がり角。街頭。
マチコウバ	町なかにある小さな工場。
マチナミ	町の道筋に家や商店が立ち並んでいる様子。
マチハズレ	町のはずれ。
マチバリ	裁縫で、布がずれないように刺しとめたり、印として刺しておく針。
マヂカ	時間・距離がかなり近づいていること。
マツ	針のような葉をたくさんつける常緑樹。
マツカサ	松の木の果実。松ぼっくり。
マツゲ	まぶたのふちに並んで生えている毛。
マツタケ	いい香りがする高級きのこ。秋、アカマツ・ツガの林に生える。食用。
マツチ	小さな木の棒の先に薬品が付いていて、そこをこすって火をつけるもの。
マツチヤ	上等の茶葉をうすでひいて粉末にしたもの。
マツト	玄関などに置く敷物。
マツハ	超音速の速さの単位。○○○１は、音速と同じ速さ。
マツヤニ	松の幹から分泌される粘り気のある樹脂。
マツリ	大勢が集まって楽しむ、にぎやかなもよおしもの。
マト	矢や弾を当てるための標的。
マトン	羊の肉。
マド	部屋の中に光を入れたり、風を通すために、壁などに空けてある穴。
マドグチ	窓を通して、品物やお金などを出したり入れたりする所。
マナイタ	魚・野菜などを包丁で切るときに下に敷く板や台。
マナザシ	物を見るときの目の様子。目つき。視線。
マナツ	夏のまっさかり。
マナツビ	一日の最高気温がセ氏三十度以上の日。
マナデシ	特にかわいがっている弟子。
マナムスメ	特にかわいがっている娘。
マナー	英語で「行儀」「態度」のこと。
マニユアル	手引書。説明書。手動式。
マネ	ほかのものと同じようなことをすること。
マネキネコ	前足で人を招く姿をした猫の置物。
マネー	お金。金銭。
マバタキ	まぶたを閉じて、すぐに開くこと。
マヒ	体の働きがとまったり、弱くなること。
マヒル	昼のさなか。白昼。
マフユ	冬のさなか。冬のもっとも寒い時期。
マフラー	細長い襟巻き。
マブタ	目の上と下にあって、目を閉じたり開いたりする皮。
マホウ	不思議なことを起こす術。魔術。
マホウビン	保温または保冷用の容器。ポット。ジャー。
マボロシ	実際には存在しないのに実在するように見えるもの。幻影。
ママ	母親。子供などが母親を呼ぶ言葉。お母さん。
ママゴト	子供がおもちゃを使って、家庭生活のまねごとをする遊び。
マミズ	塩けのない、ふつうの水。
マメ	だいず・あずき・エンドウなどの仲間で、実を食用とする作物。
マメマキ	節分の夜、鬼を追い払うために豆をまくこと。
マモウ	機械・部品・道具などがすり減ること。
マモリ	守ること。守備。防備。守護。
マモリガミ	災難から身を守ってくれる神。守護神。
マユ	まぶたの上に横長にはえている毛。
マユゲ	まゆの毛。
マヨイ	まようこと。
マヨケ	魔物などを近づけないこと。また、そのためのもの。
マヨコ	ちょうど横。まっすぐ横。
マヨナカ	夜のすっかりふけたころ。深夜。
マヨネーズ	卵黄・サラダ油・酢・塩などをよくかき混ぜて作るクリーム状のソース。
マラソン	42.195キロメートルを走る長距離競走。
マル	円形や球形に近い形。句点。
マルガオ	まるみのある顔。
マルガリ	頭髪全体を短く刈り込むこと。坊主刈り。
マルタ	切った後、皮をはいだだけの材木。
マルダシ	隠さないで、すべてをさらけ出すこと。
マルノミ	かみくだかないで、そのまま飲み込むこと。
マルボウズ	髪の毛を全部そり落とした頭。または、頭髪を短く切った頭。
マルモウケ	全部もうけになること。
マワシ	身に巻くもの。ふんどし。相撲の力士が腰に巻くもの。
マワリミチ	遠回りになる道を通って行くこと。
マン	千の十倍。百の百倍。
マンイン	それ以上人が入れないほど、いっぱいであること。
マンカイ	花がすっかり開くこと。すべての花が開くこと。
マンガ	おもしろく、こっけいに書かれた絵。
マンガク	要求、または計画したとおりの額。「○○○○回答」
マンキ	一定の期限に達すること。また、その時期。
マンゲツ	真ん丸に見える月。
マンザイ	二人の芸人がボケとツッコミに分かれてこっけいな話をする演芸。
マンシツ	すべての部屋がふさがること。
マンジユウ	小麦粉・そば粉などを練って皮とし、中にあんを包んで蒸し揚げたお菓子。
マンスイ	水量がいっぱいになること。
マンセキ	劇場・乗り物などの座席がすべてふさがること。
マンゾク	不平や不満が何もないさま。完全で不足がないこと。
マンテン	最高の得点。申し分のないこと。
マンナカ	中央。中心。
マンビキ	店内の品物をこっそり盗むこと。また、その人。
マンマル	完全に丸いこと。
マンモス	氷河時代に地球上にすんでいた象の一種。大きなきばをもつ。
マンルイ	野球で、一・二・三塁のすべてに走者がいること。
マーク	しるし。記号。
ミアイ	結婚相手を求めている男女が紹介者の仲介によって面会すること。
ミイラ	したいがくさらずにかわいて、元の形に近い状態で残っているもの。
ミウゴキ	体を動かそうとすること。「○○○○がとれない」
ミウチ	みより。親類。親子・兄弟・親戚。
ミエカクレ	見えたり隠れたりすること。
ミオクリ	見送ること。
ミオサメ	それを見ることが最後になること。
ミオボエ	以前に見た記憶があること。
ミカク	物の味を感じる感覚。
ミカタ	自分の仲間。
ミカヅキ	新月から数えて三日目前後に出る、細い弓形の月。
ミカン	黄色くあまずっぱくて円い果物。
ミカンセイ	まだ完成していないこと。未完。
ミガキコ	物をみがくのに使う粉。「歯○○○○」
ミガル	体の動きが軽快であること。
ミキ	根から上にのびて、えだや葉を付ける太い部分。
ミキサー	物をくだいたり、かき混ぜたりする装置。
ミギウデ	右側の腕。
ミギキキ	左手よりも右手の方がよく利くこと。また、その人。
ミギテ	右の手。右側。
ミケネコ	白・黒・茶の三色の毛が混じっている猫。
ミコミ	予測。うまくいきそうだという望み。
ミゴタエ	見るだけの価値。「○○○○のある演技」
ミゴロ	見るのに最もよい時期。
ミシン	布や革などを縫い合わせたり、刺繍（ししゅう）を施すのに使う機械。
ミジタク	何かをするために身なりを整えること。
ミジユク	果物などが熟していないさま。熟練されていないこと。
ミジンギリ	野菜をごく細かく切ること。
ミステリー	神秘。不思議。推理小説。怪奇小説。
ミズ	雨・川・海などとして自然界にごく普通に存在する無色透明の液体。
ミズアソビ	水に入って遊ぶこと。水を使って遊ぶこと。
ミズアビ	水をあびること。
ミズアメ	粘り気のある液状のあめ。
ミズアライ	水で洗うこと。
ミズイロ	うすい青色。空色。
ミズウミ	内陸のくぼ地に水がたまっている所。沼や池よりも大きい。
ミズカキ	水鳥・カエルなどの指の間にある薄い膜。
ミズカサ	川・池・湖などの水の量。
ミズギ	水泳や海水浴のときに身に着ける衣服。
ミズクサ	池や川など、水の中で生えている草。
ミズケ	物にふくまれている水の量。
ミズトリ	水辺に生息する鳥の総称。
ミズビタシ	すっかり水につかること。びしょぬれ。
ミズベ	川・池・湖沼などの、水のほとり。
ミズマシ	見かけだけ、実際の数量よりも多く見せること。
ミズマワリ	家屋の中で、水をよく使う場所。台所・洗面所・浴室など。
ミズムシ	足の裏や指が菌におかされてかゆくなる、ひふの病気。
ミセ	商品をならべて売っている所。商店。
ミセイネン	成年に達していない人。
ミセジマイ	店を閉めること。閉店。
ミセドコロ	ぜひとも他人に見せたい得意な場面。
ミセバン	店先で客の応対や商品の見張りをすること。また、その人。
ミセモノ	わざや芸を見せること。ショー。
ミソ	蒸した大豆に、こうじと塩を混ぜ、発酵させて作った調味料。
ミソシル	味噌仕立ての汁物。
ミソジ	三十歳。
ミソヅケ	みそにつけ込んだ食べ物。
ミゾ	土を細長くほって、水を通す場所。細長いくぼみ。
ミタメ	外から見た様子。外見。
ミダシ	内容が一目でわかるように、文章の前に書いた大きく目立つ言葉。
ミチ	人・車などが往来する所。通路。道路。
ミチカケ	月が丸くなることと欠けること。
ミチクサ	牛や馬が道ばたの草を食べてなかなか進まないこと。
ミチジユン	目的地まで行く道の順序。
ミチスウ	方程式で、値のわかっていない数。
ミチノリ	目的地までの道の長さ。距離。
ミチバタ	道の端のあたり。道のかたわら。
ミヂカ	自分の身に近い所。
ミツ	植物が出す、あまいしる。
ミツアミ	三本のひもや、三束に分けた髪を互い違いに組み合わせて編むこと。
ミツオリ	三つに折ること。
ミツカ	その月の三番目の日。一日の三倍。
ミツシツ	閉め切っていて、人の出入りができない部屋。
ミツチヤク	ぴったりとくっつくこと。
ミツド	一定の面積や体積の中に含まれているものの量の程度。
ミツバチ	みつを集めるはちの一種。
ミツプウ	すき間のないように厳重に封をすること。
ミツペイ	すき間なく、ぴったりと閉じること。
ミトオシ	遠くの方までよく見えること。将来を予測すること。
ミドコロ	見る価値のあるところ。
ミドリ	青と黄の中間の色。
ミナ	そこにいる人すべて。みんな。
ミナト	船が安全に停泊し、乗客の乗降や貨物の積み下ろしなどができるように整えた所。
ミナミ	太陽が出てくる方に向かって右側の方角。
ミナミカゼ	南から吹いてくる風。
ミナライ	見て習うこと。実地に練習すること。また、練習する人。
ミノホド	自分の能力・身分などの程度。「○○○○知らず」
ミノムシ	みのがの幼虫。枝や葉を集めて固めた巣の中にすむ。
ミハリ	周りをよく注意して番をすること。
ミバエ	外観がよいこと。見た目が立派なこと。
ミブリ	意思や感情を伝えるための身体の動き。しぐさ。「○○○手振りで伝える」
ミブルイ	寒さ・恐怖・怒り・感動などのために、体が自然とふるえ動くこと。
ミブン	社会においての地位や階級。身の上。
ミホン	買う人に前もって見せる本物、または本物に似た品物。サンプル。
ミマイ	たずねてはげましなぐさめること。また、そのために物を贈ること。
ミマワリ	警戒・監督などのために見回ること。また、その人。
ミミ	音声を聞く器官。
ミミカキ	耳あかをかき取るための細長い道具。
ミミズ	土の中にすむ、手足がなくて、ひものように細長い動物。。
ミミタブ	耳の下部に垂れ下がったやわらかな部分。
ミミナリ	外で音がしていないのに、耳の奥で何か音が感じられること。
ミミモト	耳のすぐそば。
ミムキ	振り返ってその方を見ること。関心を示すこと。
ミモノ	見る価値のあるもの。見てすばらしいと感じるもの。
ミヤクハク	心臓の拍動による動脈内圧の変動と、それに伴って生じる血管壁の波動。
ミヤゲ	旅先や外出先で手に入れ、家などに持ち帰る品物。
ミヤコ	むかし、天皇の住まいがあった所。
ミヤダイク	神社・仏閣などの建築や補修を専門に行う大工。
ミヨウジ	その家の名前。姓。
ミライ	これから先。今より後。
ミリグラム	グラムの千分の一の単位。
ミリヨク	人の心をとらえ、夢中にさせ、引きつけてしまう力。
ミリン	焼酎に蒸したもち米と米こうじを加えて醸造させた甘い酒。調味料。
ミルク	英語で牛乳。もしくは加工した牛乳。
ミレン	執着が残ってあきらめきれないこと。
ミンカ	一般の人々の住む家。
ミンカン	政府や公共機関と関係がないこと。一般の人々の社会。
ミンゾク	同じ言葉・宗教・文化などを持つ人々の集まり。
ミート	食用の肉。精肉。
ムイカ	その月の六番目の日。一日の六倍。
ムカイカゼ	進行方向から吹いてくる風。逆風。
ムカシ	ずっと前。長い年月をへだてた過去。
ムキズ	傷がないこと。
ムギチヤ	大麦を殻付きのまま煎ったものを煎じた飲み物。
ムギメシ	米に麦をまぜて炊いた飯。また、麦だけを炊いた飯。
ムギワラ	麦の実を取り去った後の茎。「○○○○帽子」
ムクチ	あまり人としゃべらないこと。口数が少ないさま。
ムゲン	限りがないさま。終わりのないさま。
ムコ	結婚して妻の家の一員となった男の人。
ムコイリ	婿となって嫁の家に入ること。
ムコウギシ	川・海峡などの向こう側の岸。対岸。
ムコクセキ	どこの国籍ももっていないこと。
ムザイ	罪がないこと。裁判で罪がないと決まること。
ムシ	人、鳥、魚、貝以外の小さな生き物。昆虫、寄生虫など。
ムシキ	食品を蒸すための用具。
ムシバ	口の中の細菌によって歯が欠けたり、穴が空いたりしたもの。
ムシブロ	浴室を密閉して蒸気で体を蒸し温める風呂。サウナ。
ムシメガネ	小さな物を拡大してみるための凸レンズ。拡大鏡。ルーペ。
ムシユウ	においやくさみがないこと。
ムシヨク	まったく色が付いていないこと。
ムジ	全体が同じ色で模様がないこと。
ムスウ	数え切れないほど、たくさんあること。
ムスコ	親にとって自分の子である男。せがれ。
ムスビメ	ひもなどを結び合わせた部分。
ムスメ	親にとって自分の子である女。
ムセイゲン	制限がないこと。制限しないこと。
ムセン	電線を使わないで、電波で伝えること。
ムダイ	作品に題がないこと。
ムダグチ	役に立たないおしゃべり。
ムダヅカイ	金品を必要のないことに使うこと。
ムダバナシ	無駄なおしゃべり。雑談。
ムチ	人や動物を打つのに用いる革ひもや細長い棒。
ムチユウ	一つのことに集中し、他のことを考えないさま。
ムツウ	痛みがないこと。
ムテイコウ	抵抗しないこと。
ムテキ	相手になるものがいないほど、強いさま。
ムテンカ	添加物を加えていないこと。
ムトウハ	いずれの政党にも属していないこと。特定の政党を支持していないこと。
ムナイタ	胸部の平らな部分。
ムナゲ	胸に生える毛。
ムナモト	胸のあたり。むなさき。
ムネ	体の前の方の、首とおなかの間。
ムネヤケ	胃から食道にかけて、焼け付くような感じや鈍い痛みがすること。
ムビヨウ	病気にかからないこと。「○○○○息災」
ムフウ	風がないこと。
ムメイ	名前が世に知られていないこと。
ムラ	田舎で、人家が多く集まっている場所。
ムラサキ	青と赤の中間の色。
ムラビト	村に住んでいる人。
ムリシ	利子がつかないこと。無利息。
ムリヨウ	料金がいらないこと。ただ。
ムレ	むらがり。集団。
メアテ	ねらいとするもの。ねらいをつけた物。
メイ	兄弟姉妹の娘。
メイアン	明るさと暗さ。
メイイ	すぐれた医者。
メイガ	すぐれていて、名高い絵。
メイキ	わかるようにはっきり書くこと。
メイキヨク	すぐれた楽曲。有名な楽曲。
メイギ	書類などに所有者・当事者として記される名前。
メイゲン	はっきりと言い切ること。
メイサク	すぐれた作品。有名な作品。
メイシ	職業・名前・住所などを印刷した小さな紙切れ。
メイシヨウ	呼び名。
メイジン	技術や能力の非常にすぐれた人。
メイセイ	よい評判。ほまれ。
メイチユウ	ねらったものに、うまく当たること。
メイトウ	すぐれた刀。名高い刀。
メイハク	はっきりしていて、疑う余地のないこと。
メイバ	すぐれた馬。世に名高い馬。
メイブツ	その地方でとくに有名なものや特産物。
メイボ	名前を書きならべた帳面。
メイメイ	名をつけること。
メイヨ	すぐれているとみとめられて、誇りに思うこと。ほまれ。
メイレイ	地位や立場の上の人が、下の人に物事をやるように言いつけること。
メイロ	込み入って迷いやすい道。
メウエ	自分より地位・階級・年齢などが上であること。
メカ	機械の仕組み。機械。
メカクシ	目を布などでおおって見えないようにすること。
メガネ	視力をよくしたり、目を守るために、ガラスを目の前に付ける器具。
メガミ	女の神様。
メキキ	物を鑑定する能力がある人。
メクバリ	あちこちに目をむけ、注意して見ること。
メグスリ	目に直接つける薬。
メザシ	イワシなどの魚の目にくしを刺し、数匹ずつ連ねて干した食品。
メザマシ	目を覚ますこと。目を覚めさせるもの。「○○○○時計」
メシ	米・麦などを炊いたもの。ご飯。
メシタ	自分より地位・階級・年齢などが下であること。
メシベ	種子植物の花の中にある雌性生殖器官。
メジルシ	ひと目でわかるようにつけた印。
メジロ	目の周りに白い縁取りがある、美しい声の小鳥。
メス	動物の性別で、卵巣を持ち、妊娠・産卵をする方。
メセン	映画・演劇などで、演技として行われる、目の方向や位置。
メタン	天然ガスの主成分。
メダカ	川や池にすむ、体長四センチメートルくらいの小さな魚。群れをなして泳ぐ。
メダマ	眼球。目の玉。「○○○焼き」
メダマヤキ	フライパンに卵を割って落とし、黄身を崩さないように焼いたもの。
メダリスト	スポーツ競技などで、メダルを獲得した人。
メダル	表彰や記念のために贈る、金属製の記章。
メツキ	物を見るときの目の様子。
メツキン	熱・薬品などによって細菌を死滅させること。殺菌。
メツボウ	ほろびてなくなること。
メヅマリ	布・網などの目がごみ・ほこりなどで詰まること。
メデイア	媒体。特に、新聞・雑誌・テレビなどの媒体。
メド	目ざすところ。めあて。目標。標的。「○○が付く」
メドレー	いくつかの曲や、曲の主要部をつないで演奏すること。
メニユー	料理品目の表。
メマイ	周囲が動揺・回転しているような感覚。目がくらんで立っていられなくなること。
メモ	大切なことを忘れないように書き留めておくこと。または、それを書き付けたもの。
メモリ	はかり、ものさしなどに付いている、量や重さの区切りを表す印。
メラニン	動物の皮膚に含まれている黒色または黒褐色の色素。
メリツト	利点。価値。長所。
メロデイー	旋律。歌や楽曲のふし。
メンカイ	相手と直接会うこと。
メンキヨ	官公庁が特定の行為について許可を与えること。「運転○○○○」
メンシキ	以前にその人に会ったことがあること。
メンセキ	土地や図形などの平面の広さ。
メンセツ	直接人に会うこと。
メンタイコ	スケトウダラの卵巣を塩漬けし、唐辛子などを加えて熟成させたもの。
メンドウ	手間がかかってわずらわしいこと。複雑で解決が容易でないこと。
メンドリ	めすの鳥。めすのニワトリ。
メンボウ	先端に脱脂綿を巻きつけた細い棒。
メーカー	物を作る人。物を作った会社。製造元。
モウイ	すさまじい勢い。猛烈な威力。
モウケ	利益。得。
モウケン	ほえたり、かみ付いたりする犬。
モウシコミ	申し込むこと。
モウシタテ	申し立てること。
モウシデ	申し出ること。
モウシヨ	激しい暑さ。酷暑。
モウジユウ	肉食で性質のあらい動物。
モウソウ	ありえないことをあれこれ想像すること。
モウドク	激しい作用のある毒。劇毒。
モウハツ	人体に生える毛の総称。特に髪の毛。
モウフ	羊毛などで織った厚い布。
モウマク	眼球の内面をおおう膜。光の刺激を受けて神経に伝える。
モウモク	目が見えないこと。
モクギヨ	僧が読経のときにたたいて鳴らす木製の仏具。
モクゲキ	その場に居合わせて実際に見ること。
モクザイ	建築・工作などの材料にする切りそろえた木。材木。
モクジ	書物の内容の見出しを順序立てて書き並べたもの。
モクセイ	太陽系の、内側から五番目にある惑星。ジュピター。
モクゾウ	木材でつくってあること。
モクタン	木を、炭焼きがまの中でむし焼きして作った燃料。
モクテキ	実現させようとして目指す事柄。目当て。
モクトウ	無言のまま心の中で祈ること。
モクドク	声を出さずに読むこと。
モクニン	だまって認めること。
モクバ	木で馬の形に作ったもの。
モクヒヨウ	射撃などの対象。まと。
モクヘン	木の切れ端。木切れ。
モクメ	木の断面に見られる、年輪・繊維などが作り出す線や模様。
モクヨウ	水曜日の次の日。
モグラ	土の中にすむ小さいけもの。穴をほってミミズや昆虫などを食べる。
モケイ	実物をかたどって小さく作った物。
モサ	勇敢ですぐれている人。能力がすぐれ、精力的に活動する人。
モサク	手探りで探すこと。「暗中○○○」
モシヤ	絵画などを、実物どおりにまねて写すこと。
モジ	言葉を視覚的に表すために、点・線などを組み合わせて作った記号。
モジバン	時計・計器などの、文字・数字・記号などが記されている盤。
モチ	蒸したもち米をうすなどでつき、さまざまな形にまとめた食品。
モチアジ	その食品が持つ特別の味。
モチゴメ	粘り気が強く、もちや赤飯にするのに適した米。
モチジカン	その人に割り当てられた一定の時間。
モチツチ	土を盛って地面を高くすること。
モチヌシ	そのものを所有している人。所有者。オーナー。
モチモノ	持っている物。所持品。所有物。
モツキン	木片を先に丸い球のついた棒でたたいて音を出す楽器。
モツコウ	木を使って家具などを作ること。
モツプ	長い柄の先に布などをつけたそうじ道具。
モデル	模型。手本となるようなもの。
モト	物事の起こり。期限。物の付け根。「○○も子もない」
モトセン	ガスを使った後は、これを閉めましょう。
モトドオリ	以前と同じ形や状態であること。
モナカ	薄くのばして焼いたもち米製の皮を二枚あわせ、中にあんをつめた和菓子。
モノオキ	普段あまり使わない道具などを入れておく場所。
モノオト	物が立てる音。
モノオボエ	物事を覚えること。記憶。
モノカゲ	物に隠れて見えない所。
モノガタリ	人に語る形式で書かれた散文作品の総称。昔から語り継がれた話。
モノゴコロ	世の中の道理や人情などを理解する心。「○○○○○がつく」
モノゴト	形のあるもの、ないもののすべて。いろいろな物や事がら。
モノサシ	物の長さを測る目盛りのついた道具。
モノシリ	いろいろなことをよく知っていること。また、よく知っている人。
モノホシ	洗濯物を干すこと。「○○○○ざお」
モノマネ	人や動物などの声や様子をまねること。
モノワカリ	物事の道理・事情などをよく理解する能力。「○○○○○のいい人」
モノワカレ	話し合いなどがまとまらないままに終わること。
モノワスレ	物事を忘れること。
モハン	見習うべきもの。手本。
モホウ	まねること。似せること。
モミガラ	イネの実を包んでいる外皮。
モミジ	秋に木の葉が赤や黄などに色づくこと。また、その葉。カエデの別称。
モミジガリ	山野に出かけて紅葉を鑑賞すること。
モモ	足の付け根からひざまでの部分。
モモイロ	うすい紅色。ピンク。
モヤシ	麦や大豆を水に付けて、暗い所で芽を出させたもの。
モヨウ	着る物や工芸品の図がら。様子。ありさま。
モヨオシ	人を集めて行う、さまざまな行事。イベント。
モヨリ	今いる場所から一番近い所。
モラル	道徳。倫理。
モリ	木がたくさん集まっておいしげっている所。
モルモツト	テンジクネズミの別称。実験台として利用される人。
モレ	もれること。必要な事柄が抜けること。
モロハ	刀剣などで、両方のふちに刃がついていること。「○○○の剣」
モンゲン	夜、門を閉める時刻。外出先から帰らなければならない時刻。
モンスター	怪物。化け物。
モンゼン	門の前。門のあたり。「○○○○払い」
モンダイ	答えさせるための問い。もめ事。解決されなければならない事件。
モンバン	門のわきにいて人の出入りを見張る番人。門衛。
モーター	原動機。発動機。電動機。自動車。
ヤエザキ	花びらが何枚も連なって咲くこと。また、その花。
ヤエバ	普通に並んでいる歯のわきに重なるように生えている歯。
ヤオチヨウ	勝負事などで、前もって勝敗を打ち合わせておき、そのとおりに勝負をつけること。
ヤオヤ	野菜を売る店や人のこと。
ヤカタブネ	屋根のある部屋を設けた和船。
ヤカン	湯を沸かす金属の道具。
ヤガイ	建物の外。戸外。屋内。野原。
ヤキアミ	魚・もちなどを焼くための金網。
ヤキイモ	焼いたサツマイモ。
ヤキザカナ	魚を焼いた料理。
ヤキソバ	蒸した中華めんに肉・野菜などの具を加えて、油でいためた料理。
ヤキトリ	鳥の肉や内臓をくしにさして焼いた食べ物。
ヤキニク	牛・豚などの肉を焼いた料理。
ヤキブタ	ひもで縛った豚肉に味をしみこませ、天火で焼いたもの。チャーシュー。
ヤキメシ	肉や野菜などを混ぜていためたご飯。チャーハン。
ヤキモノ	土器・陶器・磁器などの総称。
ヤキユウ	ベースボール。
ヤギ	羊に似ていて、角とあごひげがある動物。
ヤクザイシ	国家試験に合格し、医薬品の調合・供給などに携わる人。
ヤクシヤ	演劇を演じる人。俳優。
ヤクシヨ	役人が公務を行うところ。官公庁。
ヤクソウ	薬用になる植物。薬用植物。
ヤクソク	他の人とたがいに守ると決めたこと。
ヤクニン	国や地方公共団体の機関に勤めている人。公務員。
ヤクヒン	薬。特定の化学変化を起こさせるために用いる物質。
ヤクブツ	薬として用いられる化学物質。
ヤクミ	風味を増し、食欲をそそるために料理に添える香辛料や香味野菜。
ヤクメ	役として果たさなくてはならないつとめ。働き。
ヤクヨウ	薬として用いること。
ヤクワリ	割り当てられた務め。
ヤケイ	夜の景色。
ヤケド	熱によって皮膚をいためること。
ヤゴ	トンボの幼虫。
ヤサイ	畑でつくって食用にする植物。
ヤシキ	家。特に広い敷地に建つ大きな家。
ヤジユウ	野生のけだもの。
ヤジルシ	方向や道順などを示す矢の形の印。
ヤスアガリ	費用が安く済むこと。
ヤスウリ	値段を安くして売ること。
ヤスミ	休むこと。休息。
ヤスモノ	値段が安く、品質の劣る物。
ヤスラギ	安らかな気持ち。安心。
ヤスリ	鋼（はがね）の表面に細かい凹凸がつけられた切削工具。
ヤセ	やせていること。「○○の大食い」
ヤセイ	動植物が山野で自然のままに生育すること。
ヤセガマン	むりにがまんして、平気なふりをすること。
ヤソウ	山野に自然に生えている草。野の草。
ヤタイ	台を設けた屋根付きの小さな店。
ヤチヨウ	野生の鳥。
ヤチン	家を借りるために家の持ち主に払うお金。
ヤツキヨク	薬剤師が薬を売る店。薬剤を調合する所。
ヤトイヌシ	人を雇って仕事をさせる人。使用者。
ヤトウ	政党政治で、政権を担当していない政党。
ヤド	旅先で泊まる所。住む所。
ヤドヤ	旅客を宿泊させて営業する家。旅館。
ヤニ	木からしみ出る、粘り気のある液。褐色の粘液。
ヤヌシ	貸家の持ち主。おおや。
ヤネ	建物の上にある、雨や雪を防ぐおおい。
ヤネウラ	屋根の裏側。屋根と天井の間の空間。
ヤボウ	身の程を知らない大それた望み。
ヤマ	周りの土地よりも大きく盛り上がっている所。
ヤマイモ	山に生えるつる草のいも。
ヤマオク	山の奥。山の奥深い所。
ヤマカジ	山林が燃える火事。森林火災。
ヤマゴヤ	山中に建てた小屋。ヒュッテ。
ヤマヅミ	山のように高く積み上がっていること。
ヤマデラ	山の中にある寺。
ヤマネコ	山野にすむ野生化したネコ。
ヤマノボリ	山に登ること。
ヤマバ	物事の最も重要な場面。クライマックス。
ヤマビコ	山や谷で大きな声を出すとはね返ってくる音。
ヤマミチ	山の中の道。やまじ。
ヤマモリ	物を山のようにたくさん盛り上げること。
ヤマワケ	もうけなどをほぼ等分に分け合うこと。
ヤミ	光がなくて、真っ暗な状態。
ヤミツキ	物事に熱中してやめられなくなること。
ヤラセ	テレビなどで、事前に示し合わせて事実の記録らしく演出すること。
ヤリ	細長い棒の先にとがった刃物をつけた、昔の武器。
ヤリカタ	物事を行う方法。しかた。
ヤリガイ	やったことの効き目や価値。
ヤリナゲ	やりを投げてその到達距離を競う陸上競技。
ヤルキ	みずから物事をなしとげようとする積極的な気持ち。
ユアガリ	風呂から出たばかりの時。
ユウイギ	意義があること。価値があること。
ユウウツ	気持ちがふさいで、晴れ晴れとしないこと。
ユウエキ	利益があること。ためになること。
ユウエンチ	楽しく遊ぶための遊具・乗り物・娯楽施設などを設けた施設。
ユウガタ	太陽が西にしずみ始めるころ。
ユウキ	おそれずに立ち向かっていく強い気力。
ユウキユウ	給料が支払われること。「○○○○○休暇」
ユウグ	遊戯に使う器具。遊び道具。
ユウグウ	手厚く待遇すること。
ユウグレ	日の暮れる頃。日暮れ。
ユウコウ	友達として仲良くすること。
ユウゴウ	異なるものが一つにとけ合うこと。
ユウシユウ	他よりも一段とすぐれているさま。
ユウシヨウ	試合などに勝ち残って一番となること。
ユウシヨク	夕方の食事。夕飯。夕ご飯。
ユウジヨウ	友達どうしの親愛の情。
ユウジン	親しく対等に交わっている人。朋友。
ユウセイ	郵便に関する行政。「○○○○民営化」
ユウセン	電線を使って通信すること。
ユウダチ	夏の夕方、急にはげしく降る大粒の雨。
ユウテン	固体がとけて液体になり始める温度。
ユウドウ	誘い導くこと。
ユウノウ	能力や才能があること。
ユウハン	夕方の食事。夕食。晩飯。
ユウヒ	夕方の太陽。入り日。
ユウビン	手紙・小包を集めたり、届けたりする仕組みや仕事。
ユウフク	経済的に豊かで、生活に余裕があること。
ユウベ	太陽がしずんで、辺りが暗くなろうとするころ。日暮れ。
ユウメイ	名前がよく知られているさま。著名。
ユウヤケ	太陽がしずむとき、西の空が赤くなること。
ユウリ	利益があること。利益が見込めること。都合がよいこと。
ユウリヨウ	料金がいること。お金を取ること。
ユウリヨク	強い力、影響力を持っているさま。見込みがあるさま。
ユカ	家の中で地面や土間よりも高く、板を平らにはりつめた所。
ユカイ	楽しくて心地よいこと。
ユカゲン	湯の温度の具合。特に風呂の湯の熱さの具合。
ユカシタ	床の下。
ユカタ	夏や湯上りのときに着る木綿の着物。
ユキ	水蒸気が上空でこおって、降ってくるもの。
ユキオンナ	白い着物を着た女性の姿で現れるという雪の精。
ユキカキ	降り積もった雪をかいて除くこと。除雪。また、そのための道具。
ユキグニ	雪がたくさん降る地域。
ユキゲシキ	雪の降ってくる眺め。雪が降り積もった景色。
ユキダルマ	雪を固めて作った、だるまの形のもの。
ユキドケ	雪が解けて水になること。
ユクエ	ゆく先。ゆくて。「○○○不明」
ユケツ	血液が足りなくなった人の体の中に血をおぎなうこと。
ユケムリ	温泉・風呂などから煙のように立ちのぼる湯気。
ユゲ	湯などから立ちのぼる水蒸気が冷えて、白い煙のように見えるもの。
ユザメ	ふろから上がった後、体が冷えて寒く感じること。
ユシ	油と脂肪。
ユシユツ	自国の産物・製品・技術などを他国に送り出すこと。
ユズ	果皮に突起が多く、酸味が強い淡黄色の果肉を持つミカンの仲間の果物。
ユセイ	油の性質を持っていること。
ユソウ	車・船・航空機などで人や物を運ぶこと。
ユタンポ	中に湯を入れて、足や腰を温める金属製または陶器製の容器。
ユドウフ	切った豆腐を昆布だしの湯で熱した料理。
ユニユウ	外国から原料や製品などを買い入れること。
ユノミ	湯や茶を飲むのに使う、小ぶりの茶碗。
ユバ	豆乳を煮立て、表面にできる膜をすくい取って作った食品。
ユビ	手や足の先の枝のように分かれた部分。
ユビキリ	約束を守るしるしに、たがいに小指をからみ合わせること。
ユビサキ	指の先端。
ユビワ	金属や宝石などで作られた、指にはめる輪。
ユブネ	入浴用の湯をたたえておく大きな容器。浴槽。
ユミ	矢をつがえて飛ばすための道具。
ユミズ	湯と水。「○○○のように使う」
ユミヤ	弓と矢。
ユメ	睡眠中に本当の出来事のように頭にうかぶもの。将来の希望。
ユリカゴ	ゆり動かすように作られたかごのこと。
ユルシ	許可すること。罪などをとがめないこと。
ユワカシ	お湯を沸かすための器具。やかんなど。
ユーロ	欧州連合の統一通貨単位。
ヨアケ	夜が終わり、東の空がしだいに明るくなってくるころ。
ヨイ	酒などに酔うこと。酔った状態。
ヨイザマシ	酒の酔いをさますこと。また、その手段。
ヨウイ	したく。準備。
ヨウイク	子供を養って育てること。「○○○○費」
ヨウエキ	二種類以上の物質が均一に混合している液体。
ヨウカ	その月の八番目の日。一日の八倍。
ヨウカイ	人間には理解できない不思議な現象や存在。化け物。
ヨウカン	砂糖を入れたあんを寒天などで固めた和菓子。
ヨウガク	西洋の音楽。
ヨウガシ	西洋風の菓子。
ヨウガン	火山の噴火でマグマが火口から流れ出たもの。
ヨウキ	物を入れるうつわ。入れ物。
ヨウキユウ	ほしがること。強く求めること。
ヨウケイ	卵や肉を利用するためにニワトリを飼育すること。
ヨウケン	伝えたい事がら。用事。
ヨウゴ	使われる言葉。特定の分野で使う言葉。
ヨウシ	ある用途のための紙。
ヨウシキ	西洋のやり方や様式。西洋式。洋風。「○○○○トイレ」
ヨウシヨク	魚・貝・海藻などを人工的に育てること。
ヨウジ	しなければならない仕事。用件。
ヨウジン	気をつけること。注意すること。
ヨウジンボウ	護衛のために身辺につけておく人。
ヨウス	外から観察してわかる、そのもののありさま。
ヨウスイ	飲料・工業・消化などに使う水。
ヨウセイ	西洋の伝説・民話などに登場する自然物の精霊。
ヨウセツ	金属の接合部を熱してとかし、つなぎ合わせること。
ヨウソ	でんぷんと作用して青紫色になる物質。元素記号I。
ヨウダイ	病気の様子。病状。
ヨウチ	年が幼いこと。十分に成長していないさま。
ヨウチエン	小学校入学前の幼児のための教育機関。
ヨウテン	大切な点。肝心な点。
ヨウト	使い道。
ヨウトン	肉などを利用するために豚を飼育すること。
ヨウナシ	ヨーロッパ原産のナシの一種。ペアー。
ヨウニン	よいと認めて許すこと。
ヨウビ	一週間のそれぞれの日の名前。
ヨウフク	西洋風の衣服。
ヨウブン	生物が生きていくために必要な栄養の成分。
ヨウホウ	使用の方法。使い方。
ヨウボウ	物事の実現を求め、強く期待すること。
ヨウモウ	羊からとった毛。
ヨウヤク	文章や話の要点を短くまとめることやまとめたもの。
ヨウリヨウ	物事をうまく処理するこつ、やり方。
ヨウリヨクソ	光合成を助ける働きをする緑色の色素。
ヨカ	仕事の合間のひま。仕事を離れて自由に使える時間。
ヨカン	前もってなんとなく感じること。
ヨキン	銀行などの金融機関に金銭を預けること。また、その金銭。
ヨク	ほしいと思う気持ち。ほしがる心。
ヨクアサ	その次の日の朝。
ヨクシツ	ふろのある部屋。ふろ場。
ヨクシユウ	その次の週。
ヨクジツ	その次の日。あくる日。
ヨクジヨウ	風呂場。浴室。銭湯。
ヨクソウ	湯ぶね。風呂おけ。
ヨクボウ	何かをほしいと思う望み。
ヨゲン	未来の出来事を見通して言うこと。またその言葉。
ヨコ	水平・左右の方向。
ヨコガオ	横から見た顔。
ヨコガキ	字を横に並べて書くこと。
ヨコク	前もって告げ知らせること。
ヨコヅナ	相撲で、力士の最高位。
ヨコナガ	縦より横の方が長いこと。
ヨコナガシ	物資を正規の手続きを経ないで転売すること。
ヨサン	前もって必要な費用を見積もること。また、その費用。
ヨシアシ	よいことと悪いこと。善悪。
ヨシユウ	まだ習っていないところを前もって勉強すること。
ヨジヨウ	必要分を越えた残り。あまり。
ヨスミ	四方のすみ。
ヨセイ	これから先の人生。残りの人生。
ヨセガキ	一枚の紙などに多くの人が文章や絵を書くこと。また、その書いたもの。
ヨセン	大会や決勝の前に、前もって選び出すこと。
ヨソ	ほかのところ。別のところ。
ヨソウ	物事がこの先どうなるか、前もって見当を付けること。
ヨソウガイ	予想もしなかった成り行きになること。意外。
ヨソオイ	外観をととのえること。外観のおもむき。風情。
ヨソク	物事のなりゆきを前もっておしはかること。
ヨソミ	まったく関係ないよその方を見ること。
ヨソモノ	他の土地から来た人。
ヨゾラ	夜の空。
ヨチヨキン	預金と貯金。
ヨツカ	その月の四番目の日。一日の四倍。
ヨツト	風を受ける三角の帆をはって進む小型の船。
ヨテイ	前もって決めることや決めたこと。
ヨトウ	政党政治で、政権を担当している政党。
ヨドオシ	夜から朝まで物事を行うこと。一晩中。
ヨナオシ	世の中の悪い状態を改めること。社会の改革。
ヨナカ	夜がたいぶふけたころ。深夜。
ヨナキ	乳幼児が夜眠らないで泣くこと。
ヨネツ	電気や火を消した後の、冷め切らない熱。
ヨノナカ	人々が生活している場。世間。社会。
ヨハク	文字などが書かれていない白い部分。
ヨビ	前もって準備しておくこと。また、そのもの。
ヨビカケ	注意をひくために声をかけて呼ぶこと。多くの人に協力を求めること。
ヨビゴエ	人を呼ぶ声。
ヨビステ	「さん」や「君」などをつけないで人の名前を呼ぶこと。
ヨビナ	普段呼ばれている人や物の名。通称。
ヨビリン	人を呼ぶときや合図をするときに鳴らすベル。
ヨフカシ	夜遅くまで起きていること。
ヨフケ	夜になってかなり時間がたったころ。
ヨブン	余った分。余計なもの。
ヨホウ	予測した事柄を知らせること。「天気○○○」
ヨボウ	前もって防ぐこと。「○○○接種」
ヨマワリ	夜、警戒して見回ること。また、その人。
ヨミカキ	文字や文章を読むことと書くこと。
ヨミカタ	文字や文章を声に出して読む方法。
ヨミゴタエ	読んだときに充実した満足感が得られること。
ヨミセ	夜、道ばたに品物を並べて売る店。
ヨミチ	夜の道。
ヨメ	息子の妻となる女性。息子の妻になった女性。
ヨメイリ	女性が結婚して夫の家に入ること。また、その儀式。
ヨモギ	キク科の多年草。独特の香りを持つ。もち草。
ヨヤク	前もって約束すること。
ヨユウ	余りがあって豊かであること。ゆったりしていること。ゆとり。
ヨリミチ	目的地に行く途中についでに立ち寄ること。
ヨル	太陽がしずんでから次の朝までの暗い時間。
ヨロイ	敵の刃や矢から身を守るための防具。
ヨロコビ	喜ぶこと。うれしい気持ち。おめでたいこと。
ヨワキ	弱々しい気持ち。内気。
ヨワタリ	実社会で生活していくこと。「○○○○上手」
ヨワネ	弱々しい声。意気地のない言葉。
ヨワビ	火力の弱い火。とろ火。
ヨーグルト	牛乳やヤギの乳に乳酸菌を加えて発酵させたクリーム状の食品。
ヨーロツパ	欧州。
ライウ	雷を伴った激しい雨。
ライオン	アフリカの草原にすみ、百獣の王と呼ばれる、猫の仲間の猛獣。
ライキヤク	客が訪ねて来ること。また、その客。
ライゲツ	今月の次の月。
ライシユウ	今週の次の週。
ライシユン	次に来る春。
ライジン	雷を起こすという神。
ライテン	人が店に来ること。
ライト	英語で「右」「右側」のこと。
ライニチ	日本へ来ること。
ライネン	今年の次の年。
ライブ	生放送。生演奏。
ライン	英語で「線」のこと。
ラガン	眼鏡やコンタクトレンズなどをつけないで物を見るときの目。
ラクエン	悲しみや苦しみのなく、楽しい所。パラダイス。
ラクガキ	書いてはいけない所にいたずら書きすること。
ラクゴ	終わりに落ちのある滑稽な話芸。
ラクサツ	競争入札で、目的物や権利を手に入れること。
ラクシヨウ	楽に勝つこと。
ラクセキ	山やがけの上から転がり落ちる石。
ラクダ	砂漠にすみ、背中に一つか二つのこぶがある動物。
ラクノウ	牛・羊などを飼育し、乳を生産したり、乳製品を製造する農業。
ラクバ	乗っていた馬から落ちること。
ラクヨウジユ	秋の低温期になるとすべての葉を落とし、来春に新しい葉を生じる樹木の総称。
ラクライ	雷が落ちること。
ラグビー	楕円形のボールを使うフットボールの一種。
ラジオ	放送局が出した電波を音声に変える機械。
ラジコン	無線によって機械類を操縦・操作・制御すること。
ラセン	巻貝の殻のようにぐるぐると巻いていること。また、その形のもの。
ラツカ	高い所から下に落ちること。
ラツカサン	パラシュート。
ラツカセイ	マメ科の一年草。南京豆。ピーナッツ。
ラツキー	運がいいこと。幸運。
ラツパ	先が朝顔の花のように開いている金管楽器の呼び名。
ラツプ	食品包装用の薄いフィルム。また、それで包むこと。
ラバ	雌の馬と雄のロバの合いの子。
ラベル	品物の上にはる、はり紙。
ラムネ	炭酸水に砂糖・香料などを加えた清涼飲料。
ランオウ	卵の黄身。
ランカク	鳥・獣・魚類などをむやみにとること。
ランキリユウ	大気中に発生する不規則に乱れた気流。
ランキング	順位をつけること。等級をつけること。
ランチ	昼食。洋風の手軽な定食。
ランドセル	小学生が通学の際に学用品を入れて背負うかばん。
ランナー	走者。
ランニユウ	多くの人がむりやりにどっとおし入ること。
ランハンシヤ	光線がでこぼこのある面に当たってあちこちの方向に反射すること。
ランパク	卵の白身。
ラーメン	中華そばをゆでてスープに入れた食べ物。
ラーユ	中国料理の調味料の一つ。熱したごま油に刻んだ唐辛子を入れて作る。
リエキ	もうけ。得。ためになること。
リカ	自然界のものについて学ぶ教科。
リカイ	物事の意味やりくつがわかること。事情や人の気持ちを知ること。
リガイ	利益と損害。得と損。
リガイカンケイ	利害が相互に影響し合う関係。
リキ	便利な器具・機械。「文明の○○」
リキサク	力を込めて作った作品。
リキシ	相撲取り。
リキセツ	力を込めて主張すること。強調すること。
リキテン	てこで、力を加える場所。
リキトウ	野球などで、投手が力の限り投げること。
リク	地球の表面で、水におおわれていない部分。
リクアゲ	船で運んできた荷物を陸に運び移すこと。
リクジヨウ	陸地の上。
リクチ	地球上で、海や湖などの水でおおわれていない部分。
リクロ	陸上の道。陸上の交通機関を使うこと。
リケン	利益を受ける権利。
リコウ	かしこく、頭がいいさま。
リサイクル	不用品や廃棄物を資源として再利用すること。資源再生。
リシ	金銭を一定期間貸したことに対する報酬。利息。
リス	森林にすむ、歯がするどく、太くて丸い尾を持つ小型の動物。
リセイ	本能や感情に支配されず、道理に基づいて思考し判断する能力。
リソウ	考えられる最高の状態。
リソウキヨウ	理想として描かれる完全な世界。ユートピア。
リソク	金銭を貸した報酬として、一定の割合で定期的に受け取る金銭。利子。
リチヤクリク	航空機の離陸と着陸。
リツ	3.1415926…＝円周○○。
リツアン	計画を立てること。また、原案や草案を作ること。
リツキヨウ	道路や鉄道線路の上にかけ渡した橋。
リツコウホ	選挙で、被選挙権を持つ人が候補者として届け出ること。
リツシユウ	暦の上で秋が始まる日。太陽暦の八月八日ごろ。
リツシユン	暦の上で春が始まる日。太陽暦の二月四日ごろ。
リツシヨウ	証拠を示して事実を証明すること。
リツタイ	幅・奥行き・高さを持ち、三次元空間の一部を占める物体。
リツパ	すぐれていて見事なさま。
リツプク	腹を立てること。
リツポウ	法律を定めること。
リツポウタイ	六面の合同な正方形で囲まれた立体。正六面体。
リトウ	所属する政党・党派から離れること。
リトマスシケンシ	酸性・アルカリ性の判別に使われる紙。
リニアモーターカー	磁気で車体を浮上させて進む車両。
リネン	物事がどうあるべきかについての根本的な考え方。
リハツテン	髪を切って整えることを職業とする店。床屋。
リフオーム	建物などを改装・改築すること。
リボン	いろいろな色に染めた細長い布の飾り。
リマワリ	投資した金額に対する利子・配当などの割合。
リモコン	リモートコントロールの略。
リヤク	省くこと。省略。
リヤクゴ	一部を省略して簡略にした言葉。
リユウ	物事がそうなったわけ、原因。
リユウガク	外国に行って勉強すること。
リユウグウ	深海の底にあって、竜神や乙姫が住むという、想像上の宮殿。
リユウコウ	はやること。広くさかんに行われること。
リユウサン	硫黄・酸素・水素が化合した無色・油状の液体。
リユウシ	微細な粒。
リユウシユツ	外に流れ出る。
リユウセイ	地球の大気圏に突入した天体が空気との摩擦熱によって発光する現象。流れ星。
リユウタイ	気体と液体の総称。流動体。「○○○○○力学」
リユウチヨウ	言葉がすらすらと出て、よどみないこと。
リユウツウ	商品などが生産者から消費者のもとまで移動すること。
リユウニユウ	中に流れて入ってくること。
リユウネン	必要な単位を取得しなかった学生が、進級・卒業しないで同じ学年にとどまること。
リユウヒヨウ	海の上を漂流する氷。
リユウボク	海や川に漂っている木。流れ木。
リヨウ	昔の貨幣の単位。「千○○○箱」「千○○○役者」
リヨウアシ	左右両方の足。
リヨウウデ	両方の腕。
リヨウカイ	意味・内容をはっきり理解すること。了承すること。
リヨウガエ	ある種の貨幣をそれと同額の他の種類の貨幣と交換すること。
リヨウガワ	両方の側。
リヨウキン	見物したり、物を使ったときなどに払うお金。
リヨウケン	狩猟に用いる犬。
リヨウコク	二つの国。両方の国。
リヨウサン	同一の商品を大量に生産すること。大量生産。
リヨウシ	魚や貝や海藻などをとって生活を立てている人。
リヨウシツ	品質がよいこと。
リヨウシユウ	金銭などを受け取って収めること。「○○○○○○書」
リヨウシヨ	読んでためになる、よい本。
リヨウシン	父と母。両方の親。
リヨウダン	二つに断ち切ること。「一刀○○○○○」
リヨウチ	領有している土地。領土。
リヨウテ	左右両方の手。もろて。
リヨウテイ	主として日本料理を出す高級な料理屋。
リヨウド	領有している土地。領地。一国の主権の及ぶ土地。
リヨウドウタイ	熱や電気をよく伝える物質。導体。
リヨウホウ	二つあるもののどちらも。両者。双方。
リヨウメ	両方の目。両眼。
リヨウメン	表と裏の二つの面。両方の面。
リヨウヤク	よく効く薬。「○○○○○は口に苦し」
リヨウユウ	土地などを自分のものとして所有すること。
リヨウリ	食べ物を作ったり、食べやすくしたりすること。またはその食べ物。
リヨウリツ	両方とも成り立つこと。同時に二つもできること。
リヨカクキ	旅客を乗せて運ぶための飛行機。りょかっき。
リヨカン	お金を取って旅の人を宿泊させる所。
リヨクオウシヨクヤサイ	色素を多く含んだ野菜。
リヨクチ	草木が生い茂っている土地。
リヨケン	パスポート。
リヨコウ	旅をすること。よその土地へ行くこと。
リヨツカ	草木を植えて緑の多い場所にすること。
リヨヒ	旅行に必要な費用。路用。
リリク	陸地を離れて空へ飛び立つこと。
リレキ	その人が現在まで経てきた学業・職業などの経歴。
リレキシヨ	履歴を書いた書類。
リロン	筋道を立ててまとめられた考え。
リンカ	となりの家。
リンカク	物の周囲をふちどっている線。外形を示す線。
リンキ	その場その時に応じること。「○○○応変」
リンキオウヘン	その場その時に応じて適当な手段を講じること。
リンギヨウ	森林を育成・保護し、木材などによって利益を得る産業。
リンゲツ	出産の予定となっている月。
リンゴ	秋ごろ、赤色の丸い実がなる果物の木。
リンゴク	となりの国。
リンセン	戦いにのぞむこと。「○○○○態勢」「○○○○状態」
リンドウ	林の中の道。
リンリ	人のふみ行うべき道。道徳。モラル。
リーダー	英語で仲間の上に立って指図をする人のこと。指導者。
ルイ	野球で走者が得点するために通過しなくてはならない地点。ベース。
ルイギゴ	意味がよく似ている二つ以上の言葉。
ルイジ	よく似ていること。
ルイセン	涙を分泌する腺。
ルス	外出して家にいないこと。
ルスバン	家の人が外出しているとき、その家を守ること。または、その人。
ルスバンデンワ	電話に自動的に応答し、録音する機能を備えた電話。
ルツクス	英語で容姿のこと。
ルビ	振り仮名。振り仮名用の活字。
ルビー	紅色の宝石。
ルーツ	物事の起源。祖先。
ルーム	英語で部屋のこと。
ルール	英語で決まりや規則のこと。
レイカ	例年に比べて平均気温の低い夏。
レイガイ	通常の原則やルールにあてはまらないこと。
レイキ	冷たい空気。
レイキヤク	熱を冷ますこと、冷やすこと。
レイギ	人に対して敬意を表す作法。
レイジ	例を挙げて示すこと。
レイジヨウ	良家の娘の敬称。他人の娘の敬称。
レイスイ	冷たい水。ひやみず。
レイセイ	落ち着いて静かなさま。感情に左右されないさま。
レイセツ	礼儀と節度。
レイセン	国際間における武力によらない対立・抗争。冷たい戦争。
レイゾウ	食品などを低温で保存すること。
レイゾウコ	食べ物や飲み物などを冷やしたり、低い温度に保つための箱。
レイダイ	練習や説明のため、例として示す問題。
レイダンボウ	冷房と暖房。
レイチヨウルイ	サル目の哺乳類の総称。霊長目。
レイテン	点数・得点が全くないこと。
レイトウ	冷やしてこおらせること。
レイトウコ	氷点下以下に冷やしてこおらせるための箱。
レイハイ	神仏などを拝むこと。
レイブン	用法・書式などを説明するために、例として示す分。
レイボウ	室内の温度を外気の温度よりも低くすること。
レキシ	むかしから今にいたるまでの物事のうつり変わり。
レキシシヨウセツ	歴史上の事件や人物を題材とし、史実を踏まえて書かれた小説。
レコーダー	記録や録音をするための装置。記録係。
レシピ	料理・菓子などの調理法。また、それを記したもの。
レシート	領収書。特にレジで金額などを印字した紙。
レジ	金額などを自動的に計算して記録する機械。
レジヤー	英語で余暇のこと。
レスキユータイ	消防署などに置かれ、火災や事故の際に出動するチームの通称。
レストラン	料理店。
レスラー	レスリングの選手。
レツ	順に長く並んだもの。並び。
レツアク	品質・状態などがひどく劣っていること。
レツカ	品質・性能などが低下して、以前より悪くなること。
レツキヨ	一つ一つ並べあげること。
レツキヨウ	政治・経済的に強い力を持つ国々。
レツシヤ	旅客・貨物の輸送のために、連結された鉄道車両。
レツトウ	列をなすように細長く連なっている島々。
レデイー	婦人。
レトルトシヨクヒン	調理した食品をアルミ箔・ポリエステルなどの袋に入れて密封し、高圧・高温殺菌したもの。
レバー	機械などを操作するための取っ手。
レビユー	批評。評論。
レプリカ	美術品などの模写・複製。
レモン	黄色い実をつける、すごくすっぱい果物。
レンアイ	男女がたがいに好きになって恋しく思うこと。
レンガ	粘土に砂・石灰などを混ぜて練り、直方体などに成型してからかまで焼き上げたもの。
レンキユウ	休日が続くこと。また、その休日。
レンケツ	一続きになるようにつなぎ合わせること。
レンコウ	本人の意思に関係なく連れて行くこと。
レンゴウ	二つ以上の組織が共通の目的のために一つの組になること。
レンサイ	新聞・雑誌などに続き物として掲載すること。
レンシユウ	勉強や運動をくり返し習うこと。
レンシヨウ	続けて勝つこと。
レンジツ	ある期間続いて毎日。
レンソウ	何かの物事に関連して、別の物事を思いうかべること。
レンゾク	切れ目なく続いていること。
レンタカー	貸し自動車。
レンタン	石炭・木炭などの粉末を粘結剤でねり固めた燃料。
レントゲン	Ｘ線。Ｘ線写真。
レンニユウ	牛乳を煮詰めて濃縮したもの。たいへん甘い。
レンパツ	続けざまに発すること。続けて起こること。
レンラク	様子を相手に知らせること。伝達。
レンリツナイカク	二つ以上の政党によって構成される内閣。
レーザー	誘導放出による光の増幅装置。「○○○○光線」「○○○○ビーム」
レース	英語で競走すること。
レーズン	英語で干しぶどうのこと。
レーダー	発射した電波の反射から対象物の位置などを調べる機器のこと。
レール	鉄道の線路。カーテンなどを円滑に走らせるためのみぞのついた鋼材。
ロウカ	月日がたって古くなり、機能がおとろえてくること。
ロウガン	年老いた目。老人の目。
ロウキユウカ	古くなって役に立たなくなること。
ロウゴ	年をとってからのち。
ロウジン	おじいさんやおばあさん。年を取った人。
ロウジンホーム	高齢者が入所して必要なサービスを受ける施設。
ロウソク	糸やこよりをしんにして、ろうでかためたもの。
ロウデン	電流が回路以外にもれて流れること。
ロウドウ	体や頭を使って仕事をすること。
ロウドウシヤ	働く人。
ロウドク	文や詩を、気持ちをこめて声を出して読み上げること。
ロウニヤク	老人と若者。「○○○○○男女」
ロウバ	年を取った女性。老女。老婦。
ロウヒ	無駄づかい。
ロウヤ	カギをかけて罪人を閉じ込めておく場所。
ロウリヨク	働くこと。骨折り。労働力。
ロカ	フィルターでこすこと。
ロク	五の次の数。むっつ。
ロクオン	音を記録すること。
ロクガ	映像を記録すること。また、記録した映像。
ロクガツ	一年で六番目の月。
ログハウス	丸太を組み上げて建造した家屋。
ロケツト	推進するための装置を内臓している飛行体。「○○○○エンジン」
ロシ	液体に含まれる沈殿物・不純物などをこすのに使う紙。
ロシア	ユーラシア大陸に属する巨大な連邦国家。首都モスクワ。
ロジヨウ	道の上。道ばた。
ロセン	交通機関の、ある地点から他の地点までの道筋。
ロダン	代表作「考える人」を作ったフランスの彫刻家。
ロツカクケイ	六個の線分で囲まれた図形。
ロツカー	かぎをかけることができる、衣服や持ち物を入れるための戸棚や箱。
ロツク	かぎをかけること。
ロツコツ	胸郭を形成し、胸部の内臓を保護する左右十二対の骨。あばら骨。
ロテン	屋根などにおおわれていない所。「○○○風呂」
ロトウ	道のほとり。道端。「○○○に迷う」
ロボツト	人造人間。自動人形。自動機械。
ロンテン	議論の中心となる問題点。議論の要点。
ロンドン	イギリスの首都。
ロンパ	議論によって相手の説を破ること。
ロンピヨウ	ある物事の内容を論じ、批評すること。
ロンブン	学術的な研究の結果などを筋道を立てて述べた文書。
ロンリ	考え方や話を進めていくときの筋道。
ローン	貸し付け。貸付金。「住宅○○○」
ワイシヤツ	背広の下などに着る、えりのついた長そでのシャツ。
ワイロ	何かをしてもらうために、不正にお金や物を送ること。
ワイン	ぶどうの実を発酵させて作ったお酒。
ワオン	高さの異なる二つ以上の音が同時に鳴るときの音響。コード。
ワカ	漢詩に対して、奈良時代に発生した日本固有の詩歌。
ワカイ	仲直りすること。
ワカテ	若い人。集団の中で若いほうの人。
ワカモノ	年の若い人。青年。
ワカレミチ	道が分かれる所。進路が分かれる所。
ワガシ	日本で古くから作られてきた菓子。
ワガママ	自分の思うままにすること。身勝手。
ワガヤ	自分の家。自分の家庭。
ワキ	うでの付け根と胴の間。
ワキガ	わきの下から不快なにおいを放つ症状。また、そのにおい。
ワキゲ	わきの下に生える毛。
ワキミズ	地中からわき出てくる水。ゆうすい。
ワキヤク	映画・演劇などで主役を引き立てる役。補佐する人。
ワギユウ	日本在来のウシおよびその改良種。国内産の食用牛肉。
ワギリ	円筒形・球形の物を切り口が輪の形になるように切ること。
ワク	囲み。骨組み。物の周りを取り囲む線。
ワクセイ	恒星の周囲を公転する比較的大きな天体の総称。
ワクチン	感染症の予防に用いられる抗原の総称。
ワケ	道理。理屈。理由。原因。
ワケマエ	各自に分け与えられる分。
ワゴム	輪の形をしたひも状のゴム。
ワサビ	水のきれいな所で栽培される、からい香辛料。すしに使う。
ワザ	技術。技能。仕事。すること。
ワシ	日本古来の製法による手すきの紙。
ワシツ	たたみをしいた日本風の部屋。
ワシヅカミ	ワシが獲物をつかむように乱暴につかむこと。
ワシヨク	日本風の食事。日本料理。
ワジユツ	話をする技術。
ワスレモノ	うっかりして持ち物を置いてくること。また、その物。
ワセイエイゴ	日本で英語らしく作った言葉。
ワタ	種子のまわりに白くて長い毛をつける一年生植物。また、その毛。
ワタガシ	綿のようにふわふわした砂糖菓子。
ワタクシ	話し手が自分を指す言葉。
ワタゲ	綿のようにやわらかい毛。にこげ。
ワタシ	話し手が自分を指す言葉。
ワタシブネ	客や荷物を乗せて川・湖沼などの両岸を往復する船。
ワタリドリ	季節によってすむ場所を変える鳥。
ワタリロウカ	建物と建物の間をつなぐ廊下。
ワダイ	話の材料や種のこと。話の題目。
ワナゲ	離れた所に立てた棒などに輪を投げてはまるかどうかを競う遊び。
ワニ	水辺にすむはちゅう類の一種。口が大きく開き、足が短い。
ワビ	茶道・俳諧などの美的理念で、閑寂・質素な趣。
ワフク	日本の伝統的な衣服。日本風の衣服。着物。
ワヘイ	戦争をやめて国交を回復すること。
ワヨウ	日本と西洋。日本風と西洋風。「○○○折衷」
ワライ	わらうこと。わらい声。
ワライガオ	笑っている顔。えがお。
ワライゴト	笑って済ますような軽い事柄。
ワライジヨウゴ	酒に酔うとやたらに笑うくせがあること。
ワライバナシ	笑いながら話すような気楽な話。
ワリアイ	全体と比べた比率。
ワリカン	勘定を人数で割って各人が均等に支払うこと。
ワリザン	一つの数がもう一つの数の何倍になるかを求める計算。
ワリバシ	使うときに割って二本にする杉・竹製などのはし。
ワリビキ	一定の値段から何割か値引きすること。
ワレメ	割れたところ。さけめ。ひび。
ワレモノ	ガラス食器などの、こわれやすい物。
ワンガン	湾の沿岸。湾に沿った陸地。
ワンパク	子供がいたずらや乱暴をして手に負えない。
ワンリヨク	腕の力。
